Input	Target (Hindi)	Prediction (Hindi)
ankan	अंकन	अनकन
angkor	अंगकोर	अंग्रू
angira	अंगिरा	अंगीरा
angithi	अंगीठी	अंगीथी
angrej	अंग्रेज	अंग्रेज
angrejon	अंग्रेजों	अंग्रज्जन
anjaam	अंजाम	अनजाम
anjam	अंजाम	अनजम
antakaran	अंतकरण	अंककरण
antkaran	अंतकरण	अंकर्रण
anralon	अंतरालों	अनोलों
antralon	अंतरालों	अंटरोलन
antarkalah	अंतर्कलह	अंतरकचार
antarklah	अंतर्कलह	अंतरकाचा
antkalah	अंतर्कलह	अंतकाचा
andher	अंधेर	अंधर
andhera	अंधेरा	अंधेरा
andheraa	अंधेरा	अंधेरा
andhere	अंधेरे	अंधेर
ambar	अंबर	अंबार
amber	अंबर	अंबर
umber	अंबर	उम्बर
ambarnath	अंबरनाथ	अंबदंचाथ
ahankaar	अंहकार	आहनाकर
ahankar	अंहकार	आहानकर
anhkar	अंहकार	अनाकर
akaash	अकाश	आक्ष
akash	अकाश	आक्ष
akeelaa	अकीला	अकेला
akila	अकीला	अकेला
ankush	अकुंश	अंकुष
aksharash	अक्षरशः	अक्ष्ष
aksharashaah	अक्षरशः	अक्ष्राका
aksharashah	अक्षरशः	अक्ष्राक
asharsha	अक्षरशः	आश्राा
akhandanand	अखंडानंद	अखोदंदंवा
akhbar	अखबार	अखबार
akhabari	अखबारी	अख़बारी
akhbari	अखबारी	अख्यारी
akhabaro	अखबारो	अखाबारो
akhbaro	अखबारो	अखबाोर
akhabaron	अखबारों	अख़गारों
akhbaron	अखबारों	अखबाों
akhatar	अख़्तर	अख्रर
akhtar	अख़्तर	अख्रर
agar	अगर	अगर
august	अगस्त	एज़ेस्ट
agnivesh	अग्निवेश	अग्नेश्वर
agrata	अग्रता	अग्रता
agli	अग्ली	अग्ी
ugly	अग्ली	उगली
achyutanand	अच्युतानंद	अच्छाबंद्त
aja	अजा	आजा
atak	अटक	अटक
atka	अटका	अटका
atkav	अटकाव	अत्कवव
ataki	अटकी	अताकी
atki	अटकी	अत्ती
attention	अटेंशन	एटेशन
atarra	अतर्रा	अतरार
atrra	अतर्रा	अत्र्र
adabi	अदबी	अदबी
adbi	अदबी	एडीबी
aditi	अदिती	एडिित
adhikat	अधिकत	अधिकत
adhikaanshat	अधिकांशत	अधिकंंभश
adhikanshat	अधिकांशत	अधिकंश्थ
adhikaash	अधिकाश	अधिकाष
adhikash	अधिकाश	अधिक्ष
adhimaas	अधिमास	अधिमास
adhimas	अधिमास	अधिमास
ankahi	अनकही	अंकड़ी
anake	अनके	अनके
anke	अनके	एनके
anrasa	अनरसा	अन्रसा
unrasa	अनरसा	उन्रसा
anseekh	अनसीन	अनसेच
unseen	अनसीन	उन्सिन
ansune	अनसुने	अनसूने
unsune	अनसुने	उनसूने
uncensored	अनसेंसर्ड	इंडेंबे्स
anadaran	अनादरण	अनादनर
anadarana	अनादरण	अनादना
aniti	अनीति	अनिती
anukool	अनुकूल	अनुकूल
anukul	अनुकूल	अनुकूल
anukulin	अनुकूलित	अनुक्लिन
anukulit	अनुकूलित	अनुक्तित
anuprayog	अनुप्रयोग	अनुप्रज्ग
anuprayogi	अनुप्रयोग	अनुप्रविजी
anupryog	अनुप्रयोग	अनोपर्ग
anubhavahin	अनुभवहीन	अनुभावाही
anubhavheen	अनुभवहीन	अनुभावन
anubhavhin	अनुभवहीन	अनुभाविन
anuvaad	अनुवाद	अनुदाव
anuwad	अनुवाद	अनुदाव
anuvaadit	अनुवादित	अनुद्वित
anuvadit	अनुवादित	अनुवादित
anusaran	अनुसरण	अनुसारण
anusarand	अनुसरण	अनुसंदंड
anusuya	अनुसूया	अनुसाया
anyatr	अन्यत्र	अन्यात्र
anyatra	अन्यत्र	अन्यात्र
anyayi	अन्यायी	अन्यायी
apnana	अपनाना	अपनाना
apamishran	अपमिश्रण	अप्मोष्ण
apmishran	अपमिश्रण	अप्मिश्रण
apaaramparik	अपारंपरिक	अपराप्रक्ष
aparamparik	अपारंपरिक	अप्राप्रिक
aparamprik	अपारंपरिक	अप्रमापिक
approver	अप्रूवर	अप्राफ्र
aproover	अप्रूवर	अप्रुर
afsos	अफसोस	आफ््स
abadhit	अबाधित	अबाधित
abadhith	अबाधित	अबाध्ध
abul	अबुल	अबूल
abbas	अब्बास	अब्बास
abhinatri	अभिनत्री	अभिनात्री
abhintri	अभिनत्री	अभिनीर्री
amisha	अमीषा	अमेशा
amul	अमूल	अमूल
amod	अमोद	अमोद
amodh	अमोद	अमोदो
ammoo	अम्मू	अमू
ammu	अम्मू	अमूम
anmum	अम्मू	अनिमम
arandi	अरंडी	आरांडी
arendi	अरंडी	आरेनेड
arndi	अरंडी	आर्डी
arase	अरसे	आरसे
arse	अरसे	आर्स
arastu	अरस्तू	आरस्तु
aristu	अरस्तू	आर्सेट्स
arstu	अरस्तू	आरस्त
araamako	अरामको	आरामकों
aramco	अरामको	आरममों
aramko	अरामको	आरमांक
araasu	अरासु	आरूस
arasu	अरासु	आरूस
arun	अरुण	आरुण
arjun	अर्जुन	आर्जू
arthatantra	अर्थतंत्र	अर्थननार्थ
arthtantr	अर्थतंत्र	अर्थननार्थ
arthtantra	अर्थतंत्र	अर्थननार्थ
arthdand	अर्थदंड	आर्थंदंड
arthaniti	अर्थनीति	आर्थानित
arthneeti	अर्थनीति	आर्थनीत
arthniti	अर्थनीति	आर्थनीत
arthavyavasthaen	अर्थव्यवस्थाएं	अर्थवव्ववस्थान
arthvyavasthayen	अर्थव्यवस्थाएं	अर्थव्यवस्थायन
arthvyvasthayen	अर्थव्यवस्थाएं	अर्थव्यवस्थान
arthing	अर्थिंग	आर्थिंग
earthing	अर्थिंग	इर्थिंग
arthi	अर्थी	आर्थी
arnold	अर्नोल्ड	आरोनोड्ड
alkayada	अलकायदा	अल्कावा
alqaeda	अलकायदा	अल्दावा
alagav	अलगाव	अलागव
algaav	अलगाव	अल्गाव
algav	अलगाव	अल्गाव
alagaavavaada	अलगाववाद	अलाग्वावा
alagavavaad	अलगाववाद	अलाग्वाा
alagavavada	अलगाववाद	अलावेवाा
algavwaad	अलगाववाद	अल्गावाद
algu	अलगू	अल्ग
alaska	अलास्का	आलसका
alim	अलीम	अलिम
avadh	अवध	अवधा
avadhiyan	अवधियां	अवधायियां
avdhiya	अवधियां	अविधिया
avdhiyan	अवधियां	अवधियां
avadhiyon	अवधियों	अवधायों
avdhiyon	अवधियों	अवधियों
avarohi	अवरोही	आवार्धी
avrohi	अवरोही	अवर्धी
avaran	अवर्ण	आवरण
avarn	अवर्ण	आवरण
avran	अवर्ण	अवरण
aawaskyakta	अवश्यकता	आवस्यकक्त
avashyakta	अवश्यकता	आवश्यकता
avshykata	अवश्यकता	अवश्यकता
avashyamev	अवश्यमेव	आवश्यानव
avshymev	अवश्यमेव	अवश्या्व
avaastvik	अवास्तविक	आवस्तिविक
avastweak	अवास्तविक	आवस्ताविक
awastvik	अवास्तविक	आवस्तिविक
aviv	अवीव	अविव
avyavahaarik	अव्यावहारिक	अवयाध्यकारि
avyavaharik	अव्यावहारिक	अवयाध्यका
avyavharik	अव्यावहारिक	अवयाध्यका
ashakt	अशक्त	आशक्त
ashkt	अशक्त	आश्कत
ashasakiy	अशासकीय	आसशासिया
ashaskiye	अशासकीय	आस्काषयय
ashok	अशोक	अशूक
ashoka	अशोका	अश्का
asankhy	असंख्य	असंखे
asankhya	असंख्य	असंख्य
asangat	असंगत	आसंगत
asamaantaayen	असमानताएं	असामान्यां
asamaantayen	असमानताएं	असायान्य
asamantae	असमानताएं	असामनती
asmantayen	असमानताएं	असामानेयन
asar	असर	आसार
asainik	असैनिक	असियोंक
asparshyataa	अस्पृश्यता	अस्पृष्टा
asprashyata	अस्पृश्यता	अस्पृष्टता
asprishyta	अस्पृश्यता	अस्पृष्टत
ahamiyat	अहमियत	आहमात्य
ahmiyat	अहमियत	आह्मयत
ahitkar	अहितकर	अहिकार्र
aanand	आंनद	आनाद
anand	आंनद	आनंद
aansar	आंसर	आनसार
answer	आंसर	एंस्वर
itemon	आइटमों	इईटन
aaina	आइना	आईना
irb	आईआरबी	इरबेबी
ieee	आईईईई	आईएी
ias	आईएएस	आईएसएस
ioc	आईओसी	इईएससी
outlet	आउटलेट	आउटटे
aau	आऊ	आू
aauu	आऊ	आऊू
ou	आऊ	ओू
aao	आओ	आयो
aaoo	आओ	आयो
aakaasheeya	आकाशीय	आकाशशीय
aakashiy	आकाशीय	आकाशशीय
aakashiya	आकाशीय	आक्षिया
aagjani	आगजनी	आज़ानी
aaganan	आगणन	आगान
aagman	आगणन	आजनक
aagarkar	आगरकर	आगराकर
agarkar	आगरकर	अगररकर
aachman	आचमन	आच्मा
ajadnagar	आजादनगर	आज़बंदार
azadnagar	आजादनगर	आज़बंदार
aadambar	आडंबर	आदमाार
adambar	आडंबर	अदमबार
aadambaro	आडंबरों	आदमारोो
aadambaron	आडंबरों	आदमारोों
adambaron	आडंबरों	अदमबारों
aadat	आदत	आदात
aadatan	आदतन	आदातन
aadatein	आदतें	आदातें
aadaten	आदतें	आदातें
aadaton	आदतों	आदातों
aadar	आदर	आदार
aadhipaty	आधिपत्य	आधिप््त
aadhipatya	आधिपत्य	आधिप््त्य
aadhiptay	आधिपत्य	आधिप्त्य
aadhi	आधी	आधी
aadhunikata	आधुनिकता	आधुनिकता
aadhunikta	आधुनिकता	आधुनिकता
aadhunikikaran	आधुनिकीकरण	आधुनिकरणणण
aadhunikikarana	आधुनिकीकरण	आधुनिकरणणणा
adhunikikaran	आधुनिकीकरण	अधुनिकरणणण
aanandita	आनंदिता	आनाद्तता
aape	आपे	आपे
option	आप्शन	ऑप्टिन
aaf	आफ़	आफी
off	आफ़	ऑफी
aabhari	आभारी	आभारी
abhari	आभारी	अभारी
aamada	आमादा	आमाद
amaada	आमादा	अमादा
amadaa	आमादा	आमादा
aayakar	आयकर	आयाकार
aaykar	आयकर	आयाकर
ayekar	आयकर	आयोकार
aayush	आयुष	आयुष
ayush	आयुष	अयुष्ष
aayojik	आयोजिक	आयोजिक
aayojit	आयोजिक	आयोजित
ayojik	आयोजिक	अयोजिक
re	आरई	रे
aarch	आर्च	आर्क
arch	आर्च	आर्क
archer	आर्चर	आर्कर
aaryan	आर्यन	आर्यान
aryan	आर्यन	आर्यान
arya	आर्या	आर्या
aal	आल	आल
all	आल	एल्ल
aalishaan	आलिशान	आलीष्ण
aalishan	आलिशान	आलीष्ण
aavantit	आवंटित	आवंतित
avantit	आवंटित	अवनंतित
aavishakaron	आविष्कारों	आवशाककरों
aavishkaaron	आविष्कारों	आविष्कारों
avishkaron	आविष्कारों	अवशीकरणों
aashankaon	आशंकाओं	आशकनकों
ashankaon	आशंकाओं	आशकाकों
aasheervachan	आशीर्वचन	आशिवेशन
aashirvachan	आशीर्वचन	आश्विकचाण
ashirvachan	आशीर्वचन	आश्वा्च्चन
ashura	आशुरा	अशुरा
aashcharyajanak	आश्चर्यजनक	आश्राध्याणक
aashcharyjank	आश्चर्यजनक	आश्रा्यवों
ashcharyajanak	आश्चर्यजनक	आश्रह्मवणक
aashrit	आश्रित	आश्चित
ashrit	आश्रित	आस्थित
aasama	आसमा	आसामा
aasma	आसमा	आसमा
asma	आसमा	असमा
aasaani	आसानी	आसनी
aasani	आसानी	आसनी
asani	आसानी	असनी
interpol	इंटरपोल	इंटर्पर
intra	इंट्रा	इंट्र
industrial	इंडस्ट्रीयल	इंडोस्ट्रेल
independant	इंडिपेंडेंट	इंडीपेंेंट
independence	इंडिपेंडेंट	इंडिपेंडेंस
independent	इंडिपेंडेंट	इंडीजेंेंट
independence	इंडिपेंडेंस	इंडिपेंडेंस
indy	इंडी	इंडी
indoo	इंदू	इंडु
indu	इंदू	इंडु
influenza	इंफ्लूएंजा	इन्केजनाज
ekatthi	इकट्ठी	इक्छिथ
ekthhi	इकट्ठी	एक्थी
ikatthi	इकट्ठी	इक्छि
ikbal	इकबाल	इबलबल
iqbal	इकबाल	इकबाल
ekbalia	इकबालिया	इकबालिया
ikbalia	इकबालिया	इब्लेबाई
ikbaliya	इकबालिया	इक्लेबाया
economy	इकॉनमी	इक्नोमी
eco	इको	इको
iko	इको	इको
economics	इकोनोमिक्स	इक्नोक्सिक
ikhatiyar	इख्तियार	इखातिर्र
ikhtiyar	इख्तियार	इख्याय्र
egypt	इजिप्ट	एजप्््ट
ijisht	इजिप्ट	इज़ीष्ट
eat	इट	इत
it	इट	इईटी
its	इट्स	इस्स
ethlati	इठलाती	इथलती
ithlaati	इठलाती	इथलती
etalvi	इतालवी	इत्वाडी
italavi	इतालवी	इताववी
italvi	इतालवी	इताववी
itihaasvid	इतिहासविद	इतिहास्व्व
inlogon	इनलोगों	इन्लोगों
insight	इनसाइट	इंजीज्ट
insite	इनसाइट	इनसेट
insights	इनसाइट्स	इनजेपेट्स
insites	इनसाइट्स	इनसेस्ट्स
inset	इनसेट	इनसेट
enu	इनु	एनू
ino	इनु	इनो
inu	इनु	इनू
infantry	इन्फेंट्री	इनफनेश्री
investigation	इन्वेस्टिगेशन	इनवेंडिसेशन
emerging	इमर्जिंग	इजमरिंग
image	इमेज	इजागे
imager	इमेजर	इमागर
eiretrea	इरीट्रिया	इयरेटर
eritrea	इरीट्रिया	इरित्रीय
iritriya	इरीट्रिया	इरित्यारिया
elaakon	इलाकों	इलाकों
ialkon	इलाकों	इलककों
ilakon	इलाकों	इलाकों
ilaajon	इलाजों	इलाजों
ilajon	इलाजों	इलाजों
isha	इशा	इशा
isaraar	इसरार	इसाार
isarar	इसरार	इसारर
israr	इसरार	इसर्र
eesl	ईईएसएल	इज़ल
iisl	ईईएसएल	इज़ल
eco	ईको	इको
isabgol	ईसबगोल	इजाबबब
isbagol	ईसबगोल	इजाबाबोग
esvi	ईस्वी	एस्वी
isvi	ईस्वी	इसवी
uksaayaa	उकसाया	उक्साया
uksaya	उकसाया	उक्साया
ukhaadana	उखाड़ना	उखाड़ाना
ukhadna	उखाड़ना	उखाड़ा
ugaati	उगती	उगती
ugati	उगती	उगती
ugti	उगती	उग्ी
ugana	उगाना	उगना
ugaahi	उगाही	उगाही
ugahi	उगाही	उग्धी
ucchalne	उछलने	उच्चाने
uchhalne	उछलने	उचालने
uchlane	उछलने	उचलने
ujadane	उजड़ने	उज़ाने
ujadne	उजड़ने	उज़डने
uthe	उठे	उठे
odisa	उड़िसा	ओडिया
odissa	उड़िसा	ओडियासा
udisa	उड़िसा	उड़िसा
udelte	उड़ेलते	उड़ेेे
udeylatey	उड़ेलते	उद्यातेय
utaraai	उतराई	उतारी
utrai	उतराई	उतरे
utrayi	उतराई	उत्राय
utsuk	उत्सुक	उत्सुक
udairaj	उदयराज	उदारजज
udayraj	उदयराज	उद्याज्
uddhghosh	उद्घोष	उद्धाध
udghosh	उद्घोष	उपभूप
uddeshyaparak	उद्देश्यपरक	उद्द्यककाष
uddeshyparak	उद्देश्यपरक	उद्धायपक्ष
udham	उधम	उध्म
unnees	उन्नीस	यूनी
unnis	उन्नीस	यूनेस
upakaran	उपकरण	उपकारण
upkaran	उपकरण	उपकारण
upakaranon	उपकरणों	उपकारों
upkaranon	उपकरणों	उपकारों
upkhand	उपखंड	उपखंड
upadeshakon	उपदेशकों	उपनाककों
updeshakon	उपदेशकों	उपनिककों
upadrav	उपद्रव	उपाद्व
updrav	उपद्रव	उद्र्वव
updrawa	उपद्रव	उद्वादा
upanyaaskaar	उपन्यासकार	उपनिपकार
upnyaskar	उपन्यासकार	उपनिपकार
upabhoktaon	उपभोक्ताओं	उपभूतों
upbhoktaon	उपभोक्ताओं	उपभूतों
upabhoktawaad	उपभोक्तावाद	उपभुव्थाव
upbhoktavad	उपभोक्तावाद	उपभुव्वव
upbhoktawad	उपभोक्तावाद	उपभुव्वव
upabhoktawaadi	उपभोक्तावादी	उपभुविद्रि
upbhoktavadi	उपभोक्तावादी	उपभुव्तिवि
upbhoktawadi	उपभोक्तावादी	उपभुविद्वित
upamanyu	उपमन्यु	उपमाणुम
upmanyu	उपमन्यु	उपमाणुम
upmukhyamanti	उपमुख्यमंत्री	उपमूक्रिक्ति
upmukhyamantri	उपमुख्यमंत्री	उपमुक्तिममर्री
upmukhymantri	उपमुख्यमंत्री	उपमुक्तिम्र्री
uplabdhata	उपलब्धता	उत्ग्भावा
uplabhdhata	उपलब्धता	उपचावाता
uplabdhi	उपलब्धि	उपकेडडडी
uplabdhiyaan	उपलब्धियां	उपकावादिय
uplabdhiyan	उपलब्धियां	उपकारबददनन
uplabhiyan	उपलब्धियां	उपकावाएं
uplabdh	उपलव्ध	उपलेड
upved	उपवेद	उपवेड
upasthit	उपस्थित	उपास्थित
upsthit	उपस्थित	उपस्थित
uppal	उप्पल	उप्पल
ubhar	उभार	उभर
ubhaaron	उभारों	उभारों
ubharon	उभारों	उभारों
umas	उमस	उम्स
urvarak	उर्वरक	उर्वारक
urwarak	उर्वरक	उर्वाकर
urvarakta	उर्वरकता	उर्वात्राक
urvarkata	उर्वरकता	उर्वात्ता
urwarkata	उर्वरकता	उर्वात्ता
arwara	उर्वरा	आर्वरा
urvara	उर्वरा	उर्वारा
uljhane	उलझाने	उलझाने
ulat	उलट	उल्ट
ulati	उलटी	उल्ती
ulti	उलटी	उल्ती
ulti	उल्टी	उल्ती
ulte	उल्टे	उल्टे
ullekh	उल्लेख	उल्च्छ
ullekhit	उल्लेखित	उल्च्छित
urf	ऊर्फ	यूरीपी
urfa	ऊर्फ	उर्पा
ra	ऋ	रा
ru	ऋ	रू
rituraj	ऋतुराज	रितुुर
ruturaj	ऋतुराज	ऋतुुर
rishi	ऋर्षि	रिशी
rushi	ऋर्षि	रूषी
rishabh	ऋषभ	ऋषभा
rushabh	ऋषभ	रुशभ
enzymes	एंजाइम्स	एंजींस्स
antena	एंटेना	अंटना
antenna	एंटेना	अंतेना
antonia	एंटोनिया	एंट्निया
antoniya	एंटोनिया	एंट्निया
anderson	एंडरसन	एडनर्सन
arc	एआरसी	आर्सी
aml	एएमएल	एमल
amg	एएमजी	अमोग
ekarman	एकरमैन	इक्रामण
ekarmen	एकरमैन	इक्रेम
yakarman	एकरमैन	यक्राान
ekatmakta	एकात्मकता	एकाकमिकता
ekatmkata	एकात्मकता	एक्कमकता
exit	एक्ज़िट	एक्सिट
executive	एक्जीक्यूटिव	इक्सेटेजे्व
exhicutive	एक्जीक्यूटिव	इक्सिटेवेव
excel	एक्सल	एक्सेक्स
hec	एचईसी	हेस
hic	एचईसी	एचआईसी
atrasiya	एट्रेसिया	अत्त्रिया
atresiya	एट्रेसिया	अत्तीसाया
etresiya	एट्रेसिया	एत्तीसाया
ad	एड	एडी
add	एड	एड्ड
ed	एड	एडी
adan	एडन	अदन
aiden	एडन	ऐड़ें
adidas	एडिडास	आदेदास
adolf	एडॉल्फ	एडोर्फ
adolf	एडोल्फ	एडोर्फ
ethan	एथन	इथं
nhs	एनएचएस	एचएसएस
nmdc	एनएमडीसी	एमवेससी
nsa	एनएसए	एनएसए
ngo	एनजीओ	एगोगी
npf	एनपीएफ	एनपीपी
mx	एमएक्स	एमएंसी
mhrd	एमएचआरडी	मोर्ड
msn	एमएसएन	एमएननी
mts	एमटीएस	मैटीएस
mdma	एमडीएमए	एममीमाएमएम
mbd	एमबीडी	एमबीडी
emilie	एमिली	एमिली
emily	एमिली	इमिली
elvis	एलविस	इलवीस
allied	एलाइड	अल्डिय
elaid	एलाइड	इलाइड
alex	एलेक्स	आलेक्स
elex	एलेक्स	इलेक्स
alexis	एलेक्सिस	एलेक्सिस
alexix	एलेक्सिस	आलेक्स्स
elexis	एलेक्सिस	इलेक्सिक
alexi	एलेक्सी	आलेक्सी
alexy	एलेक्सी	अलेक्स
alder	एल्डर	अल्डर
elder	एल्डर	इल्ड
alphabet	एल्फाबेट	अल्टगेट
alvin	एल्विन	अल्विन
elvin	एल्विन	इल्विन
avlin	एवलिन	अविलन
evelyn	एवलिन	एवरेलन
evo	एवो	इवो
ashton	एश्टन	आष्टों
sa	एसए	सा
sf	एसएफ	स्फी
sm	एसएम	एसएम
sg	एसजी	सीएनजी
ncg	एससीजी	एनएससीबी
scg	एससीजी	स्एसजीबी
acetate	एसिटेट	आकेतेे
acidate	एसिटेट	अजेतेे
acf	एसीएफ	एस्फी
associationon	एसोसिएशनों	असोस्टिशन
asther	एस्थर	अश्थर
esther	एस्थर	इश्टर
aesthetics	एस्थेटिक्स	ऐवसेटिस्ट
asthetics	एस्थेटिक्स	अस्केशिस्ट
aisi	एैसी	ऑजी
actors	ऐक्टर्स	एक्टर्स
activation	ऐक्टिवेशन	अक्तियोत्य
age	ऐज	आगे
edge	ऐज	एडीजी
aillen	ऐलन	एलेलन
ellan	ऐलन	इलान
aili	ऐली	ऐली
ailly	ऐली	एली
eli	ऐली	इली
elli	ऐली	इली
auckland	ऑकलैंड	ऑक्कंंड
oakland	ऑकलैंड	ओकड़ंड
audio	ऑडियो	आडियो
object	ऑब्जेक्ट	ओजबेक्ट
objects	ऑब्जेक्ट्स	ओजयस्ट्स
oscar	ऑस्कर	ऑस्कार
oscars	ऑस्कर्स	आस्क्रस
onth	ओंठ	औंठ
oasis	ओएसिस	ऑजिस
auchhi	ओछी	औची
ochhi	ओछी	ओची
ojon	ओजोन	ओजों
ozone	ओजोन	ओज़जम
ojhal	ओझल	ओझा
ozal	ओझल	ओज़ल
auto	ओटो	ऑटो
ono	ओनो	ओनो
opal	ओपल	औप्ल
orlando	ओरलैंडो	औरांंड
original	ओरिजिनल	ऑरिफाइनल
overseas	ओवरसीज	ओवर्सीस
os	ओस	ऑस
ohayo	ओहायो	आयो
ohio	ओहायो	ओईहो
aushadhalay	औषधालय	औषधार्य
aushdhalay	औषधालय	औषधालय
aur	औेर	और
kankadon	कंकड़ों	कंकडों
kankaron	कंकड़ों	कंकरों
kanchon	कंचों	कांकों
congestion	कंजेशन	कंंगेशन
conjesion	कंजेशन	कंसेजनों
conjunction	कंजेशन	कंसेज्शन
consumer	कंज्यूमर	कंसूनर
controlled	कंट्रोल्ड	कंट्रोल्ड
kandmool	कंदमूल	कंंबूल
kandmul	कंदमूल	कंंबूल
kanmul	कंदमूल	कांमूल
kampkampi	कंपकपी	कांपप्रमी
kampkapi	कंपकपी	कंग्पफी
kambal	कंबल	कामबाल
kanbal	कंबल	कंबल
kakshak	कक्षक	कक्षक
kakshaen	कक्षाएं	कक्षाएं
kakshayen	कक्षाएं	कक्षाएं
kashaen	कक्षाएं	कषाएं
kachaura	कचौरी	कचारा
kachauri	कचौरी	कचारूरी
kachuri	कचौरी	कचूरी
katvana	कटवाना	कतवाना
katwana	कटवाना	कतवाना
katahal	कटहल	कटाहा
kathal	कटहल	कथाल
katas	कटास	कत्स
kadakadaduuma	कड़कड़डूमा	कद्दुकाणना
kadakadduma	कड़कड़डूमा	कद्दकानामों
kadkadduma	कड़कड़डूमा	कद्दकानामों
katai	कतई	कताई
kataii	कतई	कटाई
katla	कतला	कतला
katlaa	कतला	कटला
kadamtaal	कदमताल	कदमाताल
kadamtal	कदमताल	कदमात
connect	कनेक्ट	कन्नेंट
connector	कनेक्टर	कनर्मेट्टर
connecting	कनेक्टिंग	कननेक्टिंग
connectivity	कनेक्टिविटी	कन्टेक्टिटेज
kapol	कपोल	कप्लू
kpol	कपोल	कप्लू
coupolon	कपोलों	कापोलों
kapolon	कपोलों	कप्लोों
kab	कब	कब
kamaccha	कमच्छा	कामचचा
kamccha	कमच्छा	कामचचा
kamchcha	कमच्छा	कामचचा
kamjoriyan	कमज़ोरियां	काम्रियां
kamzoriyan	कमज़ोरियां	काम्रियायों
kamjoriyon	कमज़ोरियों	काम्रोोयों
kamzoriyon	कमज़ोरियों	काम्रोोों
kamjori	कमज़ोरी	कामोरीरी
kamzori	कमज़ोरी	कामोरी
kamataul	कमतौल	कमातुल
kamtaul	कमतौल	कामतुल
kamariya	कमरिया	कमारिया
kmariya	कमरिया	केमरिया
kamalini	कमलिनी	कमालिनी
kamlini	कमलिनी	कामलीनी
committee	कमिटी	कम्मिटि
commity	कमिटी	कम्यूटी
kaami	कमी	कामी
kami	कमी	कामी
karkamlon	करकमलों	कार्क्कों
karkmalon	करकमलों	कार्क्लों
kara	करा	करा
kareem	करीम	करिम
karim	करीम	कर्मिम
karae	करै	कराई
karai	करै	कराई
karolbagh	करोलबाग	करोबागाह
karolbaugh	करोलबाग	करोंबुग्ड
curt	कर्ट	कर्ट
kurt	कर्ट	कुर्त
karnafool	कर्णफूल	कररणुलु
karnaphool	कर्णफूल	करोपनिक
karnful	कर्णफूल	कारनंगल
karta	कर्ता	कर्ता
karnatak	कर्नाटक	करणाकक
karnataka	कर्नाटक	करणाकता
curv	कर्व	कर्व
curve	कर्व	कर्वे
kalkal	कलकल	कलकाल
kalyug	कलयुग	कल्गग
kalpana	कल्पना	कलपना
kalpna	कल्पना	कलपनना
kavval	कव्वाल	कववाा
qawwal	कव्वाल	कवावल
kashish	कशिश	काशिश
kasht	कष्ट	काष्ट
kasamen	कसमें	कसामें
kasmen	कसमें	कस्में
kahlaegi	कहलाएगी	कहलागगी
kahlayegi	कहलाएगी	कहलागीी
kahein	कहें	कहें
kahen	कहें	कहने
kazi	क़ाज़ी	काजी
qazi	क़ाज़ी	काजी
kanta	कांटा	कंंता
kanti	कांटी	कांती
kante	कांटे	कांटे
kanto	कांटो	कांतो
kanton	कांटों	कांतों
kandal	कांडला	कंंडल
kandala	कांडला	कंंडला
kandla	कांडला	कंडला
counter	काउंटर	कंटर
cauntron	काउंटरों	कैंटरों
counteron	काउंटरों	कंंटरों
kaag	काग	काग
kag	काग	कग
kaagaji	कागज़ी	काजजी
kaagazi	कागज़ी	कागजी
kaagji	कागज़ी	काजीजी
kaagzi	कागज़ी	कागजी
kagaji	कागज़ी	कगजजी
kagazi	कागज़ी	कगज़ी
kagji	कागज़ी	कागजी
kagzi	कागज़ी	कागजी
kaagajo	कागज़ों	कागजजो
kaagajon	कागज़ों	कागजों
kaagazon	कागज़ों	कागजों
kagajon	कागज़ों	कगाजों
kagazon	कागज़ों	कगाजों
katjoo	काट्जू	कतजू
katju	काट्जू	कतजूज
katyayani	कात्यायनी	कट्यााएं
katyayni	कात्यायनी	कट्याानी
kadiyan	कादियान	कड़ियां
kadiyana	कादियान	कड़ियां
kaabiliyat	काबिलियत	काबित्या
kabiliyat	काबिलियत	काबित्या
karkhanon	कारखानों	कारखोों
cardinalon	कार्डिनलों	कार्डियोलन
kardinalon	कार्डिनलों	करर्नियोलों
kartiki	कार्तिकी	कार्टिकी
karyakarta	कार्यकर्ता	कार्यक्र्र
karykarta	कार्यकर्ता	कार्यक्र्ा
kaalaka	कालका	कालका
kalka	कालका	कलकका
kala	काला	कला
kalis	कालिस	कलिस
coloniyan	कालोनियां	कोल्यनयों
kaloniyan	कालोनियां	कलोलियां
coloniyon	कालोनियों	कोलोयों
colonyon	कालोनियों	कलोयों
kaloniyon	कालोनियों	कलोनियों
kitani	कितनी	कितानी
kitni	कितनी	कित्नी
kiran	किरण	किरन
kiranon	किरणों	किरानों
kirnon	किरणों	किर्नों
kiraya	किराया	किर्या
kileband	किलेबंद	किलेंडंंड
kisaan	किसान	किसान
kisan	किसान	किसन
kicker	कीकर	किकर
kikar	कीकर	किकार
kunthit	कुंठित	कूठित
kundali	कुंडली	कुंदाी
kundli	कुंडली	कुंडली
cucunur	कुकुनूर	कुकुनुर
kukunoor	कुकुनूर	कुकुंुर
kukunur	कुकुनूर	कुकुनुर
kutumbakkam	कुटुंबकम्	कुटकामुक्म
kutumbkam	कुटुंबकम्	कुटककुम्म
kutunmbakam	कुटुंबकम्	कुटकककेमिया
kuprabandhan	कुप्रबंधन	कुपरबंधन
kumhar	कुम्हार	कुमहार
kurkura	कुरकुरा	कुरूकार
kuru	कुरू	कुरू
kursiyan	कुर्सियां	कुर्सियां
kursi	कुर्सी	कुर्सी
kulle	कुल्ले	कुले
cution	कुशन	काटियों
kushan	कुशन	कुशन
kusanskar	कुसंस्कार	कुसानकार
kusanskaron	कुसंस्कारों	कुस्ककर्सों
kootaa	कूटा	कूटा
kuta	कूटा	कुटा
kutaa	कूटा	कुटा
kritatva	कृतित्व	कृत्ववा
krititv	कृतित्व	कृत्यव
krititva	कृतित्व	कृत्यवत
kritiyon	कृतियों	कृतियों
krishi	कृषि	कृष्
krishanam	कृष्णम	कृष्णा
krishnam	कृष्णम	कृष्णाम
cake	केक	काक
cader	केडर	कैडर
cadre	केडर	कैडर
cameo	केमियो	केमों
kemiyo	केमियो	केमियो
kelaang	केलांग	केलांग
kelang	केलांग	केलंग
case	केस	केस
kes	केस	केस
cason	केसों	कासों
keson	केसों	केसों
canbara	कैनबरा	कंबरा
canberra	कैनबरा	कैंबररर
canedi	कैनेडी	कैनडी
kennedy	कैनेडी	केनेंद्य
camilo	कैमिलो	कैमिलो
kamilo	कैमिलो	कमूल
character	कैरेक्टर	चरर्टर
characters	कैरेक्टर्स	चरर्ट्सर
carolin	कैरोलिन	कार्लिन
caroline	कैरोलिन	कार्लिइन
carolyn	कैरोलिन	कार्लियन
calorie	कैलोरी	कैलोरी
cashback	कैशबैक	कास्केक
coin	कॉइन	कम
cong	कॉन्ग	कंंग
kong	कॉन्ग	कोंग
condom	कॉन्डोम	कोंडन
combo	कोंबो	कमबबो
koilavar	कोइलवर	कोलावार
koilover	कोइलवर	कोयोल्र
koilwar	कोइलवर	कोल्रार
kokrajhaar	कोकराझार	कोकाारार
kokrajhar	कोकराझार	कोक्राार
kokrazar	कोकराझार	कोकरागार
coachon	कोचों	कचरों
cochon	कोचों	कोचों
kochon	कोचों	कोचों
kotali	कोटली	कोटाली
coded	कोडेड	कोडेड
coma	कोमा	कोमा
coram	कोरम	कोर्म
koram	कोरम	कोरम
coal	कोल	क्रू
cholesterol	कोलेस्ट्रोल	क्लेक्टर्स
collam	कोल्लम	कल्लन
kollam	कोल्लम	कोलम
kollum	कोल्लम	कोलियम
koshikiy	कोशिकीय	कोशिकीय
koshikiya	कोशिकीय	कोशिक्य
koshkiy	कोशिकीय	कोष्कीय
coastar	कोस्टार	क्रास्टर
costar	कोस्टार	कोस्टर
kautik	कौतिक	कैटिक
kaushik	कौशिक	कौषिक
cuba	क्यूबा	कुबा
cubic	क्यूबिक	काइबिक
kyuubik	क्यूबिक	क्योबोगिक
kranti	क्रांति	क्राणती
creative	क्रिएटिव	क्रिट्येड
cricketaron	क्रिकेटरों	क्रिकेट्रों
cricketeron	क्रिकेटरों	क्रिकेक्शन
crete	क्रीट	क्रेट
krit	क्रीट	कृत
crook	क्रुक	क्रुक
cruck	क्रुक	क्रिक
cruise	क्रूज़	क्रास
cruz	क्रूज़	क्रोज
cruiser	क्रूज़र	क्रासर
cruzer	क्रूज़र	क्रुजर
kruratam	क्रूरतम	क्रोर्तम
krurtam	क्रूरतम	क्रोर्ट्
kurtam	क्रूरतम	कुर्तम
cruise	क्रूस	क्रास
cyrus	क्रूस	सीर्स
krus	क्रूस	क्रोस
crazy	क्रेज़ी	क्राजी
crest	क्रेस्ट	क्रेस्ट
krest	क्रेस्ट	क्रेस्ट
crops	क्रॉप्स	क्रोप
croaker	क्रोकर	क्रोकेकर
crocker	क्रोकर	क्रोकेकर
krokar	क्रोकर	क्रोकार
croma	क्रोमा	क्राण
chromium	क्रोमियम	च्रोमियमों
chromate	क्रोमेट	च्रांतेम
climate	क्रोमेट	क्लीमेट
climate	क्लाइमेट	क्लीमेट
class	क्लास	क्लास
classical	क्लासिकल	क्लासिकल
classi	क्लासी	क्लासी
classy	क्लासी	क्लास
classification	क्लासीफिकेशन	क्लस्ट्रिशन
clasen	क्लासेन	क्लासन
cleanser	क्लिंजर	क्लाइनर
cleg	क्लेग	क्लिग
kleg	क्लेग	क्लेग
clan	क्लेन	क्लान
clane	क्लेन	क्लान
clen	क्लेन	क्लेन
cler	क्लेर	क्लेर
cvanr	क्वांर	स्वन
quanr	क्वांर	क्वानर
qwanr	क्वांर	क्वान
kshamadan	क्षमादान	क्षेदावन
kshmadan	क्षमादान	क्षेदान
shmadan	क्षमादान	श्यादन
kshmasheel	क्षमाशील	क्षेशरी
kshmashil	क्षमाशील	क्षेश्रल
shmashil	क्षमाशील	श्यामशिल
kshinta	क्षीणता	क्षेणता
shinta	क्षीणता	शिंता
kshem	क्षेम	कीएमएम
shem	क्षेम	शेम
khand	खंड	खंड
khandwa	खंडवा	खंडवा
khatak	खटक	खाकट
khtak	खटक	खाकक
khatta	खट्टा	खातता
khadagpur	खड़गपुर	खापारुर
kharagpur	खड़गपुर	खरगपुर
khada	खड़ा	खाडा
khand	खण्ड	खंड
khanda	खण्ड	खंडा
khata	खता	खाटा
khaton	खतों	खातों
khanijon	खनिकों	खानिजों
khanikon	खनिकों	खानिकों
khabboo	खब्बू	खबूबू
khabbu	खब्बू	खबूबू
khaman	खमण	खामन
khamman	खमण	खामाान
khamariya	खमरिया	खामराया
khamriya	खमरिया	खामिराया
kharsiya	खरसिया	खर्सिया
kharaash	खराश	खर्ष
kharash	खराश	खर्श
kharcheeli	खर्चीली	खर्चाली
kharchilee	खर्चीली	खर्चाली
kharchili	खर्चीली	खर्चेली
khalnayakon	खलनायकों	खलाकाओं
khajana	ख़ज़ाना	खाजना
khawaja	ख़्वाजा	खााजा
khwaja	ख़्वाजा	ख्वाज
khaanche	खांचे	खांचे
khanche	खांचे	खांचे
khaatamey	खात्मे	खात्म
khatme	खात्मे	खातें
khala	खाला	खला
khalon	खालों	खालों
khaaskar	खासकर	खासकार
khaskar	खासकर	खसरकर
khilkar	खिलकर	खिलकर
khilauna	खिलौना	खिलाना
khilona	खिलौना	खिलानो
khisakkar	खिसककर	खिसकाकर
khudava	खुदवा	खूदावा
khudwa	खुदवा	धूद्वा
khurd	खुर्द	घुर्ड
khurda	खुर्दा	घुरदा
khush	खुश	खूश
khushiyon	खुशियों	खूशियों
khusaro	खुसरो	खुसारो
khusro	खुसरो	खूसरो
kheda	खेड़ा	खेड़ा
khemkaran	खेमकरण	खेमकार
khaira	खैरा	खारा
khor	खोर	खोर
khola	खोला	खोला
gangabaai	गंगाबाई	गंजाबी
gangabai	गंगाबाई	गंगाबी
ganjepan	गंजेपन	गंजनपन
gandak	गंडक	गंदक
gau	गऊ	गा
gatta	गट्टा	गत्ता
gadkari	गडकरी	गदकारी
gadhiya	गढ़िया	गढ़िया
gadhiyan	गढ़िया	गढ़ियां
ganataantrik	गणतांत्रिक	गणनात्त्रिक
ganatantrik	गणतांत्रिक	गणनात्त्रिक
gantantrik	गणतांत्रिक	गणतत्कृ्क
ganaraajya	गणराज्य	गननावाय
ganarajya	गणराज्य	गणनावाज
ganrajya	गणराज्य	गणनाज्य
ganarajyon	गणराज्यों	गणवाजियों
ganrajyon	गणराज्यों	गणवाजियों
gunboat	गनबोट	गुनबोत
gunbot	गनबोट	गंबूत
gar	गर	गार
garib	गरीब	गरीब
garibon	गरीबों	गारिबों
garjan	गर्जन	गर्जन
garbhagrih	गर्भगृह	गभ्यभागी
garbhgrah	गर्भगृह	गर्भग्रह
garbhgrih	गर्भगृह	गर्भग्री
garbhini	गर्भिणी	गर्भिनी
garmahat	गर्माहट	गर्माात
girls	गर्ल्स	गिर्स
galatfahmiyon	गलतफहमियों	गल्कार्ूरियो
galatfehmiyon	गलतफहमियों	गल्केक्रियों
galatfahmi	गलतफहमी	गल्कार्नी
galatfehmi	गलतफहमी	गल्क्रामी
galegi	गलेगी	गलीगी
gavan	गवां	गववन
guided	गाइडेड	गिडेड
gaba	गाबा	गबा
gartner	गार्टनर	गर्टेनर
gardener	गार्डनर	गर्नेनर
gardner	गार्डनर	गर्ननर
garnet	गार्नेट	गर्नेट
galav	गालव	गलव
galv	गालव	गालव
gidgidane	गिड़गिड़ाने	गिड़बेगनन
giriraj	गिरीराज	गिरिवाज
gire	गिरे	गिरे
gilas	गिलास	गिलास
geeta	गीता	जीता
gita	गीता	गिता
gile	गीले	गिले
gunj	गुंज	गुंज
gujara	गुजरा	गुजारा
gujra	गुजरा	गुजरा
gujari	गुजारी	गुजारी
gundosh	गुणदोष	गुंद्द
gungunate	गुनगुनाते	गुंगुतें
gungunathe	गुनगुनाते	गुंगुनाथ
guptkal	गुप्तकाल	गुप्तकाल
gupta	गुप्ता	गुपता
gufatgu	गुफ्तगू	गुफाूत
guftgoo	गुफ्तगू	गुफ्तू
guftgu	गुफ्तगू	गुफ्तु
gurcharan	गुरचरण	गुरचचनर
gurujan	गुरुजन	गुर्जन
gurda	गुर्दा	गुर्दा
gulli	गुल्ली	गुली
gujari	गूजरी	गुजारी
gena	गेना	गेना
gayl	गेल	गायल
gayle	गेल	गाये
gel	गेल	जेल
gas	गेस	गास
guess	गेस	ग्यूस
going	गोइंग	गोजन
goethe	गोएथे	गोइठे
goyethe	गोएथे	गोवे
gogunda	गोगुंदा	गोगंदा
gomatinagar	गोमतीनगर	गोमिन्नार
gomtinagar	गोमतीनगर	गोमिन्नार
gombe	गोम्बे	गोमेब
gor	गोर	गोर
goron	गोरों	गोरों
goroun	गोरों	गोरून
goshthi	गोष्ठी	गोष्ठि
gauhar	गौहर	गौहर
gyaarah	ग्यारह	ज्याराह
gyarah	ग्यारह	ज्याधर
granth	ग्रंथ	ग्रांथ
grantho	ग्रंथो	ग्रांों
granthon	ग्रंथों	ग्रांों
graft	ग्राफ्ट	ग्रेफ्ट
grapht	ग्राफ्ट	ग्रात्त
gramin	ग्रामीण	ग्रामीन
graminon	ग्रामीणों	ग्रामोों
gramoday	ग्रामोदय	ग्रामोड्य
grim	ग्रिम	ग्रिम
grain	ग्रैन	ग्रेन
gran	ग्रैन	ग्णा
glacier	ग्लेशियर	ग्लेकर
glacieron	ग्लेशियरों	ग्लेकरों
glecieron	ग्लेशियरों	ग्लेकोरों
ghanghor	घनघोर	घंगरर
ghamasan	घमासान	घमासन
gharwaale	घरवाले	घरवाले
gharwale	घरवाले	घरवाले
gharat	घराट	घरत
ghati	घाटी	घटि
ghis	घिस	घिस
ghisen	घिसें	घिसने
ghutno	घुटनो	घुटनों
ghud	घुड़	घुड़
ghumakkad	घुमक्कड़	घुमकाकाद
ghumaati	घुमाती	घुमाती
ghumati	घुमाती	घुमती
ghuspaith	घुसपैठ	घुस्पात्थ
ghuspet	घुसपैठ	घुस्पेट
ghuspaithiyan	घुसपैठियों	घुस्पान्त्य
ghuspaithiyon	घुसपैठियों	घूस्पात्तिय
ghuspetiyoun	घुसपैठियों	घुस्पेतियों
ghoonse	घूंसे	घोंसे
ghunse	घूंसे	घुंसे
ghoomti	घूमती	घूमती
ghumati	घूमती	घुमती
ghumthi	घूमती	घुमती
ghumti	घूमती	घुमती
ghoomte	घूमते	घुमते
ghumate	घूमते	घुमाते
ghumte	घूमते	घुमते
ghumthe	घूमते	घुमतेे
ghoomaane	घूमाने	घूमाने
ghumaane	घूमाने	घुमने
ghumane	घूमाने	घुमने
gherna	घेरना	घेरना
ghernaa	घेरना	घेरना
gholate	घोलते	घोलते
gholte	घोलते	घोलते
ch	च	चे
cha	च	चा
chandar	चंदर	चंदार
chander	चंदर	चांडर
chandra	चंदर	चांडर
chanda	चंदा	चंडा
chandaa	चंदा	चंडा
chande	चंदे	चांडे
chandrama	चंद्रमा	चांडरमा
chandrma	चंद्रमा	चांडर्म
chakaleshwar	चकलेश्वर	चक्ववेश्वर
chakleshwar	चकलेश्वर	चक्ववेश्वर
chakkaron	चक्करों	चक्करणों
chacheri	चचेरी	चचेरी
chatargy	चटर्जी	चत्रग्य
chatarji	चटर्जी	चत्रजी
chatterjee	चटर्जी	चट्टविजी
chatushkon	चतुष्कोण	चाषुत्तों
chapate	चपेट	चपटे
chapet	चपेट	चापेट
chamoli	चमोली	चममिली
charachar	चराचर	चररचार
chalaaki	चलाकी	चलाकी
chalaki	चलाकी	चलकी
chahchahahat	चहचहाहट	चहहाकभा
chahate	चहते	चाहते
chahte	चहते	चहते
chahara	चहरा	चहरा
chehra	चहरा	चेहारा
childhood	चाइल्डहुड	चिलोद्ड
chak	चाक	चक
chatate	चाटते	चटते
chatane	चाटने	चटने
chatne	चाटने	चटने
chatumars	चातुर्मास	चत्समुर
chaturmas	चातुर्मास	चत्रपूम
chadrein	चादरें	चड़रें
chadren	चादरें	चाड्र
chardiwari	चारदिवारी	चर्द्यायी
charu	चारु	चारु
chare	चारे	चरे
charo	चारो	चारो
charger	चार्जर	चार्गर
charter	चार्टर	चरर्टर
chahega	चाहेगा	चेहागा
chintu	चिंटू	चिंतु
chintajanak	चिंताजनक	चिंगकन
chintajank	चिंताजनक	चिंगातं
chithhiyon	चिठ्ठियों	चित्यों
chiththiyon	चिठ्ठियों	चित्थियों
chitthiyon	चिठ्ठियों	चित्तियों
chidchide	चिड़चिड़े	चिड़चेड
chiththa	चित्त	चिठता
chitt	चित्त	चित्ट
chiththi	चित्ती	चिठती
chitti	चित्ती	चित्ती
chithrkari	चित्रकारी	चित्रकारी
chitrkari	चित्रकारी	चित्रकारी
chithrkaron	चित्रकारों	चित्रकरण
chitrakaron	चित्रकारों	चित्रकारों
chitrkaron	चित्रकारों	चित्रकारों
chita	चीता	चिता
chithade	चीथड़े	चित्डे
chumban	चुंबन	चुंबन
chunban	चुंबन	चुंबन
chukata	चुकाता	चुकता
chukatha	चुकाता	चुक्ता
chunani	चुननी	चुननी
chunnani	चुननी	चुननानी
chunni	चुननी	चुन्नी
chunavaa	चुनवा	चुनावा
chunva	चुनवा	चुन्वा
chunwa	चुनवा	चुन्वा
chunauti	चुनौति	चुनौती
chunothi	चुनौति	चुनौथी
chunautiyon	चुनौतियों	चुनौतियों
chunothiyon	चुनौतियों	चुनोतियों
chubh	चुभ	चुभ
chase	चेज	चासे
chej	चेज	चेज
chatak	चेटक	चटक
chetak	चेटक	चेतक
chettiar	चेट्टियार	चेत्ट्रर
chettiyar	चेट्टियार	चेत्त्रार
chelsea	चेल्सी	चेल्स
chelsy	चेल्सी	चेल्सी
choriyaan	चोरियां	चोरियां
choriyan	चोरियां	चोरियां
choriyo	चोरियों	चोरियो
choriyon	चोरियों	चोरियों
chankati	चौंकती	चंकाती
chaunkati	चौंकती	चौंकती
chaunkti	चौंकती	चौंकती
chauntis	चौंतीस	चैंटिस
chaunsath	चौंसठ	चौंनठ
chausath	चौंसठ	चौस्थ
chaukiyon	चौकियों	चौकियों
chaukon	चौकों	चौकों
chaupalo	चौपालों	चौपौल
chaupalon	चौपालों	चौपालों
chaube	चौबे	चौबे
chaubepur	चौबेपुर	चौदुपुर
chhapra	छपरा	छापारा
chhapan	छप्पन	छपन
chhappan	छप्पन	छापन
chhalaavaa	छलावा	छलवा
chhalava	छलावा	छलवा
chhaviyaan	छवियां	छावियां
chhaviyan	छवियां	छावियां
chhaviyon	छवियों	छावियों
chhae	छाए	छा
chhaye	छाए	छाए
chhach	छाछ	छच
chhachh	छाछ	छच्च
chhaanakar	छानकर	छानकार
chhankar	छानकर	छानकर
chaya	छाया	चाा
chhaya	छाया	छाा
chhaayaakaar	छायाकार	छायकार
chhayakar	छायाकार	छायकार
chayaprati	छायाप्रति	चयापर्ति
chhaayaaprati	छायाप्रति	छावप्रिति
chhayaprati	छायाप्रति	छानिप्ति
chhit	छिट	छित
chhid	छिड़	छिड
chhida	छिड़ा	छिड़ा
chhidaa	छिड़ा	छिड़ा
chhidi	छिड़ी	छिड़ी
chheepate	छिपते	छीपटे
chhipate	छिपते	छिपटे
chhipte	छिपते	छिप्टे
chhup	छुप	छुप
chhupi	छुपी	छुपी
chhupy	छुपी	छुप्
chupi	छुपी	चुपी
chhpe	छुपे	छीपर
chhupe	छुपे	छुपे
chhooti	छूती	छोटी
chhuti	छूती	छुट्ती
chhedate	छेड़ते	छेड़ते
chhedte	छेड़ते	छेड़ते
chhodane	छोड़ने	छोड़ने
chhodne	छोड़ने	छोड़ने
janjeer	जंजीर	जन्मीर
zanjeer	जंजीर	जन्मीर
janjeera	जंजीरा	जन्मिरा
janjira	जंजीरा	जनसीयारा
jnjiraa	जंजीरा	जंजीरा
janjeere	जंजीरें	जन्मीर
janjeeren	जंजीरें	जनजीररन
janjiren	जंजीरें	जनसेमरें
zanjiren	जंजीरें	जनसेमरें
zanzeeren	जंजीरें	जनजीरीन
janjeeron	जंजीरों	जनपीरों
janjiroa	जंजीरों	जनसियोरो
janjiron	जंजीरों	जनपीरों
janziron	जंजीरों	जनपीरों
zanjeeron	जंजीरों	जनपीरों
jakad	जकड़	जाकड़
jakd	जकड़	जकड़
jagadishpur	जगदीशपुर	जगद्युरूप
jagdeeshpur	जगदीशपुर	जगद्युर
jagdishpur	जगदीशपुर	जगद्सिपुर
jajh	जज	जाझ
judge	जज	जुडेग
jujge	जज	जुजेे
jatavaadaa	जटवाड़ा	जटवााड़ा
jatbaada	जटवाड़ा	जटडााड़ा
jatvada	जटवाड़ा	जटवााद
jatwada	जटवाड़ा	जटवााद
jatelta	जटिलता	जटेलता
jatilataa	जटिलता	जटिलता
jatilta	जटिलता	जातितता
jatiltaa	जटिलता	जटीलता
jtilta	जटिलता	जतिलता
jtiltaa	जटिलता	जतिलता
jateltaon	जटिलताओं	जटिलतां
jatilataon	जटिलताओं	जटिलताओं
jatiltaon	जटिलताओं	जटिलताओं
jtiltaaon	जटिलताओं	जटिलताओं
jtiltaon	जटिलताओं	जटिलताओं
jadata	जड़ता	जादता
jadataa	जड़ता	जादता
jadta	जड़ता	जड़ता
jaddi	जड़ी	जड़ड़ी
jadee	जड़ी	जाड़ी
jadi	जड़ी	जड़ी
jdi	जड़ी	जड़ी
jado	जड़ों	जाडो
jadon	जड़ों	जाडों
jataane	जताने	जटाने
jatane	जताने	जटाने
jtane	जताने	जटाने
janagana	जनगण	जनवाना
jangan	जनगण	जांगन
janajeevan	जनजीवन	जन्माावन
janajivan	जनजीवन	जनजीवन
janjeevan	जनजीवन	जन्जनव
janjevan	जनजीवन	जनजेवन
janjivan	जनजीवन	जनसेवान
janjivn	जनजीवन	जनप्रवां
jananeta	जननेता	जननेता
janantaa	जननेता	जन्नता
janneta	जननेता	जन्नता
jannetaa	जननेता	जन्नता
janasangh	जनसंघ	जनसंंघ
jansangh	जनसंघ	जनसंख
jansngh	जनसंघ	जनसंंख
janasoochana	जनसूचना	जनसुना
janasuchana	जनसूचना	जनसुचना
janasuchna	जनसूचना	जनसुच्छान
jansuchana	जनसूचना	जनसुचना
jansuchna	जनसूचना	जनसुचना
jansuchnaa	जनसूचना	जनसुचना
janaab	जनाब	जानब
janab	जनाब	जानब
janaopayogi	जनोपयोगी	जनपाजिजी
janopayogee	जनोपयोगी	जनपोदियो
janopayogi	जनोपयोगी	जनपोगियो
jannat	जन्नत	जन्नत
janmashati	जन्मशती	जन्मश्ति
janmshati	जन्मशती	जन्माषित
jamashedpur	जमशेदपुर	जमशुपुर
jamshedpur	जमशेदपुर	जाशुपुर
jayate	जयते	जायते
jayte	जयते	जाते
jaideep	जयदीप	जैदीप
jayadeep	जयदीप	जायदपी
jayadip	जयदीप	जायदपीप
jaydeep	जयदीप	जयोपीप
jayan	जयन	जाान
jayen	जयन	जाएं
jaishankar	जयशंकर	जैशाकर
jayshankar	जयशंकर	जयश्कर
jaisawal	जयसवाल	जैवासाल
jaiswal	जयसवाल	जैवसाल
jaya	जया	जाा
jayaa	जया	जाा
jalaajali	जलांजलि	जलाजली
jalaanjali	जलांजलि	जलांगली
jalanjali	जलांजलि	जलांगाई
javeri	जवेरी	जवेरी
zaveri	जवेरी	जवेरी
jahar	जहर	जहार
jaher	जहर	जहहर
zahar	जहर	जहार
zaher	जहर	जहहर
jaharon	जहरों	जहहों
jahron	जहरों	जहहों
zameer	ज़मीर	जमीर
zamir	ज़मीर	जमूर
jaao	जाओ	जाओ
jao	जाओ	जाओ
jaagkar	जागकर	जागकर
jagakar	जागकर	जगरकर
jagkar	जागकर	जग्कर
jaagati	जागती	जागती
jagati	जागती	जगती
jaagane	जागने	जाने
jagane	जागने	जगने
jagne	जागने	जगने
jagrat	जागृत	जगर्त
jagrit	जागृत	जगर्ित
jagrut	जागृत	जगरत
jaago	जागो	जागो
jago	जागो	जागो
jaajpur	जाजपुर	जापुर
jajapur	जाजपुर	जाजपुर
jajpur	जाजपुर	जापुर
jaade	जाड़े	जाड़े
jade	जाड़े	जाड़े
jadav	जादव	जादव
jaankaar	जानकार	जानकर
jankar	जानकार	जानकर
jaankaariyan	जानकारियां	जनकारियां
jankariyan	जानकारियां	जनकारियां
jaankaariyon	जानकारियों	जनकारों
jaankariyon	जानकारियों	जाकररियों
jankariyon	जानकारियों	जनकारियों
jaankaari	जानकारी	जानकारी
jaankari	जानकारी	जानकारी
jankari	जानकारी	जानकरी
jaaniye	जानिए	जानीय
janiye	जानिए	जनने
jaaneman	जानेमन	जानेमान
jaanemann	जानेमन	जानेें
janeman	जानेमन	जन्मना
jaafarpur	जाफरपुर	जाफपूर्व
jafarpur	जाफरपुर	जफ़पूर्
jaamwal	जामवाल	जामवाल
jamval	जामवाल	जमववाल
jamwal	जामवाल	जमववल
jaame	जामे	जामे
jame	जामे	जमे
jayal	जायल	जायल
joyal	जायल	जोयल
george	जार्ज	ज्योग्ज
jarj	जार्ज	जार्ज
javadekar	जावड़ेकर	जवादेकर
javdekar	जावड़ेकर	जवादेकर
jaavid	जाविद	जाविद
javid	जाविद	जावद्ध
jitane	जितने	जितने
jitne	जितने	जितने
jinak	जिनके	जिनक
jinake	जिनके	जिनके
jinke	जिनके	जिंके
jinaalay	जिनालय	जिनाए
jinalay	जिनालय	जिनाय
gypsion	जिप्सियों	गिजपपियों
gypsiyon	जिप्सियों	गिजपूरियों
jimma	जिम्मा	जिम्मा
jimmaa	जिम्मा	जिमाा
jian	जियान	जिआन
jiyaan	जियान	जियान
jiyan	जियान	जियन
jiyo	जियो	जियो
giraffe	जिराफ	गिरफफे
ge	जीई	जे
jee	जीई	जी
ji	जीई	जि
genee	जीनी	गेनी
jeenee	जीनी	जीनी
jini	जीनी	जिनी
jiyanpur	जीयनपुर	जीयनापुर
jivantata	जीवंतता	जीवनतता
jivantataa	जीवंतता	जीवनतता
jivantta	जीवंतता	जीवनतता
jeevnon	जीवनों	जीवोों
jivano	जीवनों	जीवाों
jivanon	जीवनों	जीवाों
gsat	जीसैट	गौत
gset	जीसैट	ग्वेट
jut	जुट	जूट
jute	जुट	जूते
jute	जुटे	जूते
judate	जुड़ते	जुड़ते
judte	जुड़ते	जूड़ते
judaas	जुडास	जुदास
judas	जुडास	जुदास
junshaan	जुनशान	जूंशन
junshan	जुनशान	जूंशन
jurmane	जुर्माने	जुरमेन
jurrat	जुर्रत	जुर्त
julana	जुलना	जुलना
julanaa	जुलना	जुलना
julna	जुलना	जुलना
joodi	जूडी	जोड़ी
judi	जूडी	जुड़ी
julian	जूलियन	जुलियां
jm	जेएम	जम
jedda	जेद्दा	जेड़डा
jen	जेन	जेन
zen	जेन	जेन
geoffrey	जेफरी	ज्योफर
jefary	जेफरी	जेफररी
jeffery	जेफरी	जेफेरी
jack	जैक	जबक
jackman	जैकमैन	ज़ककान
jackie	जैकी	जाकी
jacky	जैकी	जाक्
jackson	जैक्सन	जकक्सों
jagger	जैगर	जग्र
jaigar	जैगर	जगार
jaingranthon	जैनग्रंथों	जैग्रोोथों
jaingrnthon	जैनग्रंथों	जैग्रोोथों
jaina	जैना	जाना
genion	जैनियों	गेनियों
jainiyon	जैनियों	जैनियों
jockey	जॉकी	जोके
job	जॉब	जोब
jo	जो	जो
jong	जोंग	जोंग
jokhimo	जोखिमों	जोखमों
jokhimon	जोखिमों	जोखिमों
jodte	जोडते	जोड़ते
jodtey	जोडते	जोड़ते
jorte	जोडते	जोर्टे
jod	जोड़	जोड
jodiyaan	जोड़ियां	जोड़ियां
jodiyan	जोड़ियां	जोड़ियां
jodi	जोड़ी	जोड़ी
jota	जोता	जोता
joshua	जोशुआ	जोषुआ
jauhar	जौहर	जाार
jauhariyon	जौहरियों	जौहारियों
jauhari	जौहरी	जौहारी
gyandev	ज्ञानदेव	ज्ञानेवव
jvaare	ज्वारे	जुरारे
jvare	ज्वारे	ज्वरे
jware	ज्वारे	ज्वरे
jhanjhari	झंझरी	झंझारी
jhadane	झडने	झाड़ें
jhadne	झडने	झड़ने
jhadapon	झड़पों	झाडपों
jhapakana	झपकाना	झपकाना
jhapkaanaa	झपकाना	झपकाना
jhapkana	झपकाना	झपकाना
jhar	झर	झार
zar	झर	जार
jhadol	झाड़ोल	झड़ोल
jharol	झाड़ोल	झारूल
jhaapad	झापड़	झापड़
jhapad	झापड़	झाड़
jhalawad	झालावाड़	झलावा
jhunjhalahat	झुंझलाहट	झुंभा्त
jhunjhamahat	झुंझलाहट	झुंभानाथ
jhunjhlahat	झुंझलाहट	झुंभा्त
jhukana	झुकना	झूकना
jhukna	झुकना	झूकना
jhunjhunu	झुन्झुनू	झूंभुमू
jhelate	झेलते	झेलते
jhelte	झेलते	झेलते
jhonkane	झोंकने	झोंकने
jhonkne	झोंकने	झोंकने
jhola	झोला	झोला
jholi	झोली	झोली
takarata	टकराता	तकराता
takraata	टकराता	टकर्ता
takrata	टकराता	टकर्ता
takarane	टकराने	टकराने
takraane	टकराने	टकराने
takrane	टकराने	टकराने
tatti	टट्टी	तत्ती
taanka	टांका	तांका
tanka	टांका	तंका
tanki	टांका	तंकी
taangne	टांगने	तांगें
tangane	टांगने	तंगाने
tangne	टांगने	तंगाने
tighten	टाइटन	टिगटन
titan	टाइटन	टिटन
titen	टाइटन	टिटें
tifun	टाइफून	तिफून
typhoon	टाइफून	तीपकोण
timing	टाइमिंग	टिइजनंग
town	टाऊन	टीन
takia	टाकिया	तकीया
takiya	टाकिया	तकीया
tata	टाटा	तता
toilet	टायलेट	टोइलेट
tylet	टायलेट	टाइटल
tikata	टिकता	टिकता
tikta	टिकता	टिकता
tiktaa	टिकता	टिकता
ticker	टिकर	टाइकर
tikar	टिकर	टिकर
teeki	टिकी	तीकी
tiki	टिकी	तिकी
teenteen	टिनटिन	तींतीन
tintin	टिनटिन	टिंटीन
tips	टिप्स	टिप्स
tibbi	टिब्बी	टिबबीब
tibby	टिब्बी	टाब्बे
timtimaate	टिमटिमाते	टिम्नामते
timtimate	टिमटिमाते	टिम्नेमट
tkdl	टीकेडीएल	टैक्ड
teach	टीच	तीच
tvs	टीवीएस	ट्वेस
tender	टेंडर	टेंडर
tendor	टेंडर	टेंडोर
technical	टेक्निकल	टेकननिकल
tedhi	टेढ़ी	तेड़ी
tenesi	टेनेसी	टेनेसी
tennessee	टेनेसी	टेनेनसी
terence	टेरेंस	टेरेंस
terrence	टेरेंस	टेरेंस
testo	टेस्टों	टेस्टो
teston	टेस्टों	टेस्टन
testosteron	टेस्टोस्टेरॉन	टेस्टेशन
testosterone	टेस्टोस्टेरॉन	टेस्टेशन
tong	टोंग	टोंग
token	टोकन	टोकन
totake	टोटके	टोटके
totke	टोटके	टोटक
tobacco	टोबेगो	टोबबकू
tobego	टोबेगो	टोबबब
tune	ट्यून	तुने
tyun	ट्यून	त्युन
ttunar	ट्यूनर	त्तुनार
tuner	ट्यूनर	टनेरो
trucko	ट्रकों	ट्रोक
truckon	ट्रकों	ट्रॉकों
tribute	ट्रिब्यूट	ट्रेबेट
trim	ट्रिम	ट्रिम
tree	ट्री	ट्री
thappa	ठप्पा	ठपपा
thitholi	ठिठोली	ठिथौली
ththoli	ठिठोली	ठूथौली
thukraakar	ठुकराकर	ठुक्रार
thukrakar	ठुकराकर	ठुक्रार
dakt	डक्ट	डक्त
duct	डक्ट	डूक्ट
dagmagane	डगमगाने	डगजााने
date	डटे	डाते
daten	डटे	डातें
dabara	डबरा	दबारा
dabra	डबरा	दबरा
dabok	डबोक	दबाक
dove	डव	डोव
dancers	डांसर्स	डैंर्स
dansers	डांसर्स	डैंसर्स
dining	डाइनिंग	डिनिंग
doubt	डाउट	डॉब्ट
dought	डाउट	डूढ़त
download	डाउनलोड	डावनोड्ड
downloading	डाउनलोडिंग	डावर्डिलोंग
downloding	डाउनलोडिंग	डावर्गनंंग
dakiya	डाकिया	डक्या
dabar	डाबर	दबार
dabur	डाबर	दाबुर
daynasoron	डायनासोरों	दायरसों
dinosauron	डायनासोरों	डिनुरूरों
dynasoro	डायनासोरों	दिनारसो
dynasoron	डायनासोरों	डिनररसन
daalti	डालती	दालती
dalati	डालती	दलती
dalti	डालती	डालती
dala	डाला	दला
daali	डाली	दाली
dali	डाली	दली
dega	डिएगो	देगा
diaego	डिएगो	डियोगो
diago	डिएगो	डियोगो
decaine	डिकेन	डेकेने
dicken	डिकेन	डिकन
diken	डिकेन	डिकन
defensiv	डिफेंसिव	डेफेनेंस
defensive	डिफेंसिव	डिफाइंस्वी
delay	डिले	देलाए
dele	डिले	डेले
drs	डीआरएस	ड्रास
deo	डीईओ	डेयो
dn	डीएन	डीएनएं
dth	डीटीएच	ड्थ
dw	डीडब्ल्यू	ड्वी
ddt	डीडीटी	डड्टी
dbs	डीबीएस	डीबीएस
deluxe	डीलक्स	डिलिक्स
do	डु	डो
dubone	डुबोने	डबबें
dumra	डुमरा	दुम्रा
doobkar	डूबकर	दूबकार
dubkar	डूबकर	दुबकार
data	डेट	दता
date	डेट	डाते
debt	डेट	डेब्ट
dating	डेटिंग	डाटिंग
dates	डेट्स	डेट्स
deputy	डेप्यूटी	डेपर्टी
darias	डेरियस	डारिस
darius	डेरियस	दारिस
delivery	डेलिवरी	डेलेवारी
doctorate	डॉक्टरेट	डॉक्टररीट
doctret	डॉक्टरेट	डॉक्टररट
dodger	डोजर	डोड़ग
doser	डोजर	डोसर
donovan	डोनोवैन	डोन्न
donpovain	डोनोवैन	डोप्राजन
domino	डोमिनो	डोमोनो
domain	डोमेन	दोमनें
domen	डोमेन	डोमन
dolomite	डोलोमाइट	डोल्टिमी
dosa	डोसा	डोसा
drai	ड्राई	ड्रे
dry	ड्राई	ड्रे
dribble	ड्रिबल	ड्रबबबल
drible	ड्रिबल	ड्रेबल
drag	ड्रैग	ड्रोग
dhakana	ढकना	ढकाना
dhakna	ढकना	ढकना
dhaaniyon	ढाणियों	धानियों
dhaniyon	ढाणियों	धनियों
dhaani	ढाणी	धानी
dhani	ढाणी	धानी
dhikala	ढिकाला	धिकाा
dheeth	ढीठ	ढेठ
dhith	ढीठ	ढीथ
dheelapan	ढीलापन	धीलपान
dhilapan	ढीलापन	धीलापन
dhoondhate	ढूंढते	धूंधते
dhoondhnte	ढूंढते	धूंधनेे
dhoondhte	ढूंढते	धूंधते
dhundhate	ढूंढते	धुंधते
dhundhte	ढूंढते	धुंधते
dhoondha	ढूंढा	धूंधा
dhundha	ढूंढा	धुंधा
dhoondhe	ढूंढे	ढूंडेे
dhundhe	ढूंढे	धुंधे
dhoondhen	ढूंढें	ढूंढने
dhundhen	ढूंढें	धुंडें
dholak	ढोलक	धोल्क
tantrika	तंत्रिका	तांत्रिक
tantrikeeya	तंत्रिकीय	तंत्रिकीय
tantrikiy	तंत्रिकीय	तांत्रिकीय
tantriy	तंत्रिकीय	तांत्रीय
takdeer	तकदीर	टकरी
takdir	तकदीर	टकर्डर
taqdir	तकदीर	टकरीदा
takali	तकली	टकाली
takli	तकली	टकली
taki	तकी	तकी
tadaagi	तड़ागी	तड़गी
tadagi	तड़ागी	ताड़ि
tansukh	तनसुख	तनसूक
tanisha	तनीशा	तनेशा
tapasvini	तपस्विनी	ताप्रविण
tapaswini	तपस्विनी	ताप्रविण
tapsvini	तपस्विनी	ताप्रविनी
tabassum	तबस्सुम	तबसमम
tabssum	तबस्सुम	तबससम
tabhi	तभी	ताभी
tar	तर	तार
tarr	तर	तार
taraf	तरफ	तारफ
taraste	तरसते	तरस्ते
tarsate	तरसते	तर्त्े
taraashne	तराशने	तराशने
tarshne	तराशने	तर्शनन
tarasha	तराशा	तराशा
tarashi	तराशी	तर्शी
tarkvaadi	तर्कवादी	तर्कवादी
tarkvadi	तर्कवादी	तर्कवादी
tarkwadi	तर्कवादी	तर्कवादी
tarko	तर्को	तारको
talpade	तलपडे	तलपाे
talaashanaa	तलाशना	तलाशना
talashana	तलाशना	तलाशना
tale	तले	ताले
talleen	तल्लीन	तललीन
tallin	तल्लीन	तललीन
taslim	तस्लीम	तस्मिम
taaki	ताकि	ताकी
taki	ताकि	तकी
taajik	ताजिक	ताजिक
tajik	ताजिक	ताजिक
taajul	ताजुल	ताजुल
tajul	ताजुल	तजुल
taatya	तात्या	ता्य
tattya	तात्या	तत्त्य
tatya	तात्या	तत्य
taapmaan	तापमान	तापाान
tapman	तापमान	तापमान
taarakol	तारकोल	तार्कु
taarkol	तारकोल	तार्कुल
tarkol	तारकोल	तारकोल
taarif	तारीफ़	तारिफ
tareef	तारीफ़	तरीफ
tarif	तारीफ़	तारिफ
taare	तारे	तारे
tare	तारे	तारे
taalaband	तालाबंद	तालांंद
talaband	तालाबंद	तलबंंद
tikona	तिकोना	टिकानो
tithi	तिथी	तिथी
timaahi	तिमाही	तिमाही
timahi	तिमाही	तिमाही
timir	तिमिर	टिमिर
tirap	तिरप	तिरप
tirp	तिरप	तिर्प
tiraskarat	तिरस्कृत	तिरस्क्र
tiraskrit	तिरस्कृत	तिरस्कृत
tiraskrut	तिरस्कृत	तिरस्तृत
tirskrit	तिरस्कृत	तिरस्कृत
tisari	तिसरी	तिसारी
tisri	तिसरी	तिस्री
teerandaji	तीरंदाजी	तीरांदाजी
teerndaaji	तीरंदाजी	तीरंदाजी
tirandaji	तीरंदाजी	तिरानदाजी
tukka	तुक्का	टुक्का
tumne	तुमने	तुमने
tumhare	तुम्हारे	तुमहाे
turkey	तुर्की	तुर्के
turki	तुर्की	तुर्की
ten	तें	तेन
tendoo	तेंदू	तेंदु
tendu	तेंदू	तेंदु
tendukheda	तेंदूखेड़ा	तेनुभद्भ
tejpur	तेजपुर	तेजपुर
tezpur	तेजपुर	तेजपुर
tejasvi	तेजस्वी	तेजावीव
tejaswi	तेजस्वी	तेजाववी
tejsvi	तेजस्वी	तेज्वीपी
tejaab	तेजाब	तेजाब
tejab	तेजाब	तेजाब
teliyon	तेलियों	तेलियों
teliy	तेलीय	तेली
teliya	तेलीय	तेलिया
tevar	तेवर	तेवार
tevaron	तेवरों	तेवारों
tevron	तेवरों	तेवरों
taiyab	तैयब	तैयाब
todna	तोडना	तोडना
tota	तोता	टोटा
toshi	तोषी	तोशी
taulane	तौलने	तौलने
taulne	तौलने	तालने
taula	तौला	तौला
trilok	त्रिलोक	त्रिको
thakakar	थककर	थककार
thakkar	थककर	ठककार
thapthapane	थपथपाने	ठप्टाेे
thapthpane	थपथपाने	ठप्पनेश
thermal	थर्मल	थे्माम
thaati	थाती	ठाती
thati	थाती	ठाती
thaamne	थामने	थामे
thamne	थामने	थामे
theater	थिएटर	ठेतर
theter	थिएटर	ठेटर
thank	थैंक	ठाक
thanks	थैंक्स	ठंक्स
thnaks	थैंक्स	थनककस
thaila	थैला	थैला
thela	थैला	थेला
thailiyaan	थैलियां	थैलियां
thailiyan	थैलियां	थैलियां
thailiyon	थैलियों	ठालियों
thailon	थैलों	थैलों
thomas	थोमस	थोमस
thrast	थ्रस्ट	थ्रस्त
thrust	थ्रस्ट	थ्रस्ट
three	थ्री	थ्री
dange	दंगे	डंंगे
dand	दंत	डंंड
dant	दंत	डांट
dakkan	दक्कन	दककन
dagaabaaja	दगाबाज	दगाबाजा
dagabaaj	दगाबाज	दगाबाज
dagabaj	दगाबाज	दगाबाज
dagabaja	दगाबाज	दगाबाज
dan	दन	डां
dafanai	दफनाई	दफनाई
dafnaai	दफनाई	दफनाई
dafnaayi	दफनाई	दफनाई
damyanti	दमयंती	दाम्यात्मी
damit	दमित	देमित
darvaajaa	दरवाजा	दरावाज
darvaja	दरवाजा	दरवाज
darwaja	दरवाजा	दरवाज
daras	दरस	दरस
dariyaai	दरियाई	दरियाई
dariyai	दरियाई	दरियाई
dariapur	दरियापुर	दरियापुर
dariyapur	दरियापुर	दरियापुर
dariba	दरीबा	दरीबा
darjan	दर्जन	दर्जन
darre	दर्रे	डररे
darshae	दर्शाई	दर्शाए
darshaee	दर्शाई	दर्शाई
darshai	दर्शाई	दर्शाई
dal	दल	डाल
dalbeer	दलबीर	डलेली
dalbir	दलबीर	डल्लर
dalel	दलेल	डलेल
dalele	दलेल	डलेले
dalon	दलों	डालों
dashahra	दशहरा	दशाार
dashara	दशहरा	दशाा
dussehra	दशहरा	दुष्याकार
dashansh	दशांश	दशांश
dastaane	दस्ताने	दस्ताएं
dastane	दस्ताने	दस्ताने
dastaveji	दस्तावेजी	दस्तावाजी
dastveji	दस्तावेजी	दास्तुवीजी
dastavejon	दस्तावेजों	दसस्वतें
dahak	दहक	दहक
dahala	दहला	दहला
dahalaa	दहला	दहला
dahla	दहला	दहला
dadar	दादर	ददार
daam	दाम	दाम
daaman	दामन	दामन
daman	दामन	दमन
daamaad	दामाद	दामाव
damad	दामाद	दानद
damini	दामिनी	दामिनी
daamon	दामों	दामों
damon	दामों	डामों
daal	दाल	दाल
dal	दाल	डाल
daalee	दाली	दाली
daali	दाली	दाली
dalee	दाली	दली
dali	दाली	दली
daalon	दालों	दालों
dalo	दालों	डालो
dalon	दालों	डालों
daahsanskar	दाहसंस्कार	दश्कासमकर
dahsanskar	दाहसंस्कार	दहस्माकर
dahine	दाहिने	दहीने
digambar	दिंगबर	डिजंगर
dingabar	दिंगबर	दिंगाार
dingbar	दिंगबर	डिंगारर
digar	दिगर	डिगर
dinajpur	दिनाजपुर	दिनापपुर
dinakpur	दिनाजपुर	दिनापुर
dimaag	दिमाग	दिमाग
dimag	दिमाग	दिमाग
dimaagi	दिमागी	दिमाजी
dimagi	दिमागी	दिमागी
dimaagon	दिमागों	दिजाजों
dimagon	दिमागों	दिजानों
diyaas	दियास	दियास
diyas	दियास	दियास
diljale	दिलजले	दिलझाए
dilvaaye	दिलवाए	दिलवाये
dilvae	दिलवाए	दिलावे
dilwaaye	दिलवाए	दिलवाये
dilwaye	दिलवाए	दिलवाए
dilaaya	दिलाया	दिलाया
dilaya	दिलाया	दिलाया
dilayaa	दिलाया	दिलाया
dilaayi	दिलायी	दिलाई
dilayi	दिलायी	दिलाई
dilip	दिलीप	डिलिप
deen	दीन	डीं
din	दीन	डिन
deep	दीप	डीप
dip	दीप	डीपी
deepa	दीपा	दीपा
dipa	दीपा	दिपा
diwaaliya	दीवालिया	दिवालिया
diwaliya	दीवालिया	दिवालिया
dukaan	दुकान	दुकान
dukan	दुकान	दुकान
dukaane	दुकानें	दुकने
dukaanen	दुकानें	दुकाने
dukanen	दुकानें	डुकनें
dukh	दुख	दुख
dukha	दुख	दुखा
dukhi	दुखी	दुखी
dugune	दुगुने	डुगने
dughartna	दुघर्टना	दुगरात्न
durghatna	दुघर्टना	दूर्घतान
dutkaar	दुत्कार	दूतकरा
dudhiya	दुधिया	दुधिया
dudhiyaa	दुधिया	दुधिया
dupatta	दुपट्टा	दूपातता
duptta	दुपट्टा	डुप्तता
dubai	दुबई	दुबाई
dubaara	दुबारा	दुबरा
dubara	दुबारा	दुबरा
durruh	दुरूह	दुरुर
duruh	दुरूह	दुरु
durghatnaon	दुर्घटनाओं	दूर्घताओं
durghtnaon	दुर्घटनाओं	दूर्घताओं
dusre	दुसरे	डुसरे
doosri	दूसरी	दूष्री
dusri	दूसरी	दुस्री
dradhataa	दृढ़ता	द्राधाता
dradhta	दृढ़ता	द्राधात
dridhta	दृढ़ता	दृद्धता
deghaat	देघाट	देघात
deghat	देघाट	देघत
dete	देते	डेट
deodar	देवदार	देरोर
devdaar	देवदार	देवादार
devdar	देवदार	देवादर
devidaas	देवीदास	देवासाा
devidas	देवीदास	देवासाज
dainy	दैन्य	दैन
dainya	दैन्य	दान्य
daivagy	दैवज्ञ	दैवाज्ञ
daivajny	दैवज्ञ	दैवासजन
daivgya	दैवज्ञ	दैवाग्य
dogune	दोगुने	डोगेें
doharaane	दोहराने	दोहराने
doharane	दोहराने	दोहराने
dohrane	दोहराने	डोहरेे
daudane	दौड़ाने	दौड़ने
daulat	दौलत	दौलत
draupadi	द्रोपदी	द्पूपदी
dropadi	द्रोपदी	द्रापदी
drohi	द्रोही	द्रूची
dvadashi	द्वादशी	द्द्धाशी
dwadashi	द्वादशी	द्द्दशी
davarpal	द्वारपाल	दावप्र
dwarpal	द्वारपाल	द्वापपाल
davesh	द्वेश	देवेष
dvesh	द्वेश	द्वेश
dwesh	द्वेश	द्वेश
dhanda	धंधा	धंडा
dhandha	धंधा	धांधा
dhanarthi	धनार्थी	धनार्थी
dhani	धनी	धानी
dhanop	धनोप	धनप
dhabbe	धब्बे	धब्बे
dharati	धरती	धरती
dharti	धरती	धारती
dharne	धरने	धारने
dharma	धर्मा	धर्म
dhaarakon	धारकों	धारकों
dharakon	धारकों	धारकों
dharkon	धारकों	धारकों
dhuandhar	धुंआधार	धुनाधर
dhunaadhaar	धुंआधार	धुनधार
dhunaadhar	धुंआधार	धुनधार
dhunadhar	धुंआधार	धुनधरर
dhundhalapan	धुंधलापन	धुंधापन
dhundhlapan	धुंधलापन	धुंधापन्न
dhut	धुत	धूट
dhu	धू	धू
dhun	धून	धुन
dhuun	धून	धुन
dhumar	धूम्र	धूमर
dhumra	धूम्र	धूम्र
dhote	धोते	धोटे
dhyey	ध्येय	ध्ये
dhyeya	ध्येय	ध्याया
nange	नंगे	नंगे
nakum	नकुम	नकाम
naksalavaadiyon	नक्सलवादियों	नक्स्कावादियो
naksalwadiyon	नक्सलवादियों	नक्स्कावियों
naxalvaadiyon	नक्सलवादियों	नक्क््वदादियो
naxalwaadiyon	नक्सलवादियों	नक्क््वदादियो
naksalavaadi	नक्सलवादी	नक्क्ववादी
naksalvadi	नक्सलवादी	नक्क्षवादी
naxalvaadi	नक्सलवादी	नक्कवादीदी
naxalwaadi	नक्सलवादी	नक्कवादीदी
nageena	नगीना	नगीना
nagina	नगीना	नगीना
nach	नच	नच
najar	नजर	नज़र
nazar	नजर	नज़र
najariye	नजरिए	नज़रीय
najrie	नजरिए	नज़री
najriye	नजरिए	नज़रीय
nazarie	नजरिए	नज़रीर
najariye	नजरिये	नज़रीय
najriye	नजरिये	नज़रीय
najrein	नजरें	नज़रेे
najren	नजरें	नज़रें
najraana	नज़राना	नज़ाना
nazraana	नज़राना	नज़रणा
nazrana	नज़राना	नज़रना
najd	नज्द	नज़
najda	नज्द	नज़ाा
nathu	नथु	नाथु
nabh	नभ	नाभ
narita	नरिता	नरीता
narula	नरूला	नरुला
narega	नरेगा	नरेगा
naresh	नरेश	नारेश
nargis	नर्गिस	नार्गिस
navtej	नवतेज	नवेटेज
navbahaar	नवबहार	नवदाकार
navbahar	नवबहार	नवदाकार
navy	नव्य	नववी
navya	नव्य	नववय
nasht	नष्ट	नास्त
nahae	नहाए	नहाए
nahaye	नहाए	नहाए
nice	नाइस	निसस
nagesh	नागेश	नादेश
naachi	नाची	नाची
nachi	नाची	नाची
naacho	नाचो	नाचो
nacho	नाचो	नाको
naate	नाते	नाटे
nate	नाते	नेट
nanaki	नानकी	नननी
nanki	नानकी	ननकी
nabaleeg	नाबालिग	नबाबी
nabalig	नाबालिग	नबबाग
nabaligon	नाबालिगों	नबबिगन
naabhi	नाभि	नाभी
nabhi	नाभि	नाभी
naamdan	नामदान	नामदन
namdan	नामदान	नांदन
naamroop	नामरूप	नामपूर
naamrup	नामरूप	नामपूर
namrup	नामरूप	नामपुर
namankan	नामांकन	नमाककन
namantaran	नामांतरण	नमर्तरण
namumkin	नामुमकिन	नमूक्मिन
naamon	नामों	नामों
namon	नामों	नमों
nayakon	नायकों	नायकों
narad	नारद	नरद
naraj	नाराज	नारज
naavikon	नाविकों	नाविकों
navikon	नाविकों	नविककों
naashte	नाश्ते	नाश्ते
nashte	नाश्ते	नाश्ते
nick	निक	निक
nik	निक	निक
nikaalate	निकालते	निकातते
nikaalte	निकालते	निकाते
nikalate	निकालते	निकाते
nikalte	निकालते	निकाते
nikharata	निखरता	निखाता
nikharataa	निखरता	निखाता
nikhara	निखरा	निखारा
nikharaa	निखरा	निखारा
nikhare	निखरे	निखारे
nikhaar	निखार	निखार
nikhar	निखार	निखार
nikhaaraa	निखारा	निखारा
nikhara	निखारा	निखारा
nigohi	निगोही	निग्डी
nijaampur	निजामपुर	निजानपुर
nijampur	निजामपुर	निजानपुर
nizampur	निजामपुर	निजानपुर
nit	नित	निट
niptaane	निपटाने	निपटाएं
niptane	निपटाने	निपटने
nibhaakar	निभाकर	निभाकर
nibhakar	निभाकर	निभाकर
nimna	निम्र	निमाना
nimr	निम्र	निम्र
nimra	निम्र	निम्र
niraksharata	निरक्षरता	निर्काष्ठा
niraksharataa	निरक्षरता	निर्काष्ठा
niraksharta	निरक्षरता	निर्काष्ठा
niraksharon	निरक्षरों	निर्कारों
nirupama	निरुपमा	निरूपाा
nirupamaa	निरुपमा	निरूपाा
nirupma	निरुपमा	निरूपामा
nivaaran	निवारण	निवारण
nivaran	निवारण	निवारण
nivaaraniy	निवारणीय	निवारणीय
nivaaraniya	निवारणीय	निवाणनीय
nivarniy	निवारणीय	निवारणीय
nivesh	निवेश	निवेश
niveshak	निवेशक	निवेशक
niveshakon	निवेशकों	निवेशकों
niveshit	निवेशित	निवेशित
niveshon	निवेशों	निवेशों
nishaadaraaj	निषादराज	निशावाज
nishadraj	निषादराज	निश्वाज
nishdaraaj	निषादराज	निश्वाज
nihaarati	निहारती	निहातती
nihaarti	निहारती	निहात्री
neend	नींद	नींड
nind	नींद	निंड
neet	नीत	नीत
neeti	नीति	नीती
niti	नीति	निती
neetigat	नीतिगत	नीतिगत
nitigat	नीतिगत	नितिटगत
neeraj	नीरज	नीराज
niraj	नीरज	निराज
neelaambar	नीलांबर	नीलंबार
nilaambar	नीलांबर	निलामार
nilaanbr	नीलांबर	निलांंदर
nilambar	नीलांबर	निलंबर
noo	नू	नू
nu	नू	नू
nrity	नृत्य	नृत्य
nritya	नृत्य	नृत्य
nrutya	नृत्य	नृत्य
naturopathy	नेचुरोपैथी	नतुर्थप्रीय
net	नेट	नेट
netvest	नेटवेस्ट	नेटेस्ट्ट
netwest	नेटवेस्ट	नेटेेट्स
nets	नेट्स	नेट्स
netaaon	नेताओं	नेताओं
netaon	नेताओं	नेताओं
netraheen	नेत्रहीन	नेटेरानी
netrhin	नेत्रहीन	नेटरीन
namesake	नेमसेक	नमेसेक
nemsek	नेमसेक	नेमेक्स
neva	नेवा	नेवा
newa	नेवा	नेवा
newaa	नेवा	नेवा
nation	नेशन	नाटियों
nairaashya	नैराश्य	नैराशय
nairashy	नैराश्य	नैराश्य
nairashya	नैराश्य	नैर्श्य
knock	नॉक	केनीएकसी
knorr	नॉर	कैनर्स
nor	नॉर	नोर
nokia	नोकिया	नोकिया
nokha	नोखा	नोखा
nova	नोवा	नोवा
nautanki	नौटंकी	नौटककी
notanki	नौटंकी	नोटककी
nautan	नौतन	नौटान
pankchar	पंक्चर	पंचार
puncture	पंक्चर	पंक्टर
pankti	पंक्ति	पंकटी
panktiyon	पंक्तियों	पंकटियों
panchangon	पंचांगों	पंचाकों
punchangon	पंचांगों	पंचाजों
panchhiyon	पंछियों	पंचियों
panchiyon	पंछियों	पंचियों
panjabi	पंजाबी	पंजाबी
punjabi	पंजाबी	पुंजाजी
pandalon	पंडालों	पंडलों
pakate	पकते	पकते
pakte	पकते	पकते
paki	पकी	पकी
pakshapati	पक्षपाती	पक्षपपति
pakshpaati	पक्षपाती	पक्षपपति
pachranga	पचरंगा	पछाड़वाग
patak	पटक	पटक
pada	पड़ा	पदा
padaa	पड़ा	पदा
padegi	पड़ेगी	पदेगी
patila	पतीला	पतीला
patilaa	पतीला	पतीला
patniyaan	पत्नियां	पटनीयां
patniyan	पत्नियां	पटनीयां
pathari	पथरी	पथारी
pathri	पथरी	पथरी
pad	पद	पाड
paday	पद्य	पदाए
pady	पद्य	पद्य
padya	पद्य	पद्य
padhaaranaa	पधारना	पदानारा
padharana	पधारना	पदानारा
padharna	पधारना	पदधारण
pappi	पप्पी	पापपी
publication	पब्लिकेशन	पुब्टिकन
parchhae	परछाई	पर्चा
parchhai	परछाई	पर्चाई
parjiviyon	परजीवियों	परिज्वीनों
paran	परण	परण
parana	परण	परणा
paratdaar	परतदार	परातार
paratdar	परतदार	परातार
pardes	परदेस	पर्ेड
parnaanaa	परनाना	परनाना
parnana	परनाना	परनाना
parlok	परलोक	परकोक
parawarti	परवर्ती	परवार्थी
parvarti	परवर्ती	परवार्थी
parwarti	परवर्ती	परवार्थी
parvaan	परवान	परवान
parvan	परवान	परवान
parwaan	परवान	परवान
parasaad	परसाद	परादद
parsaad	परसाद	परसदा
parsad	परसाद	परसद
paraajay	पराजय	पराजय
parajay	पराजय	पराज
paraajayon	पराजयों	पराजायों
parajayon	पराजयों	पराजनियों
paraatpar	परात्पर	परपाप्र
paratpar	परात्पर	परपत्र
parikalp	परिकल्प	परफ़्र्
parichaarikaa	परिचारिका	परिच्राका
paricharika	परिचारिका	परिचिरका
parimaan	परिमाण	परियाम
parimana	परिमाण	परिमाना
periman	परिमाण	पेर्मिन
parimanaatmak	परिमाणात्मक	परियोत्मक
perimanatmak	परिमाणात्मक	परर्यक््मक
parivartansheel	परिवर्तनशील	परिवर्शनशील
parivartanshil	परिवर्तनशील	परिवर्शनशील
parishadein	परिषदें	परिशादन
parishaden	परिषदें	परिशादें
parikshan	परीक्षण	परिक्षण
parikshanon	परीक्षणों	परिक्षकों
paroste	परोसते	परस्टे
palaash	पलाश	पल्श
palash	पलाश	पल्श
palla	पल्ला	पल्ला
pallaa	पल्ला	पल्ला
pulsar	पल्सर	पुल्सर
pulser	पल्सर	पुल्स
pahnaanaa	पहनाना	पहनाा
pahnana	पहनाना	पहनाा
pehnana	पहनाना	पहनाा
pahalgaam	पहलगाम	पहलागम
pahalgam	पहलगाम	पहलागा
pahalvi	पहलवी	पहलवी
pahlavi	पहलवी	पहलववी
pehlavi	पहलवी	पहलववी
pahunchana	पहुंचना	पहुंचना
pahunchanaa	पहुंचना	पहुंचना
pahunchna	पहुंचना	पहुंचना
pahunchaayein	पहुंचाएं	पहुंचाएं
pahunchaen	पहुंचाएं	पहुंचने
pahunchayen	पहुंचाएं	पहुंचाएं
pahunchaati	पहुंचाती	पहुंचाते
pahunchati	पहुंचाती	पहुंचेती
paayegaa	पाएगा	पाएगा
payega	पाएगा	पायेगा
paao	पाओ	पाओ
pao	पाओ	पाओ
pachchajanya	पाञ्चजन्य	पच्चावान
pajjanya	पाञ्चजन्य	पजजन्या
panchjanya	पाञ्चजन्य	पंख्यान्य
paapaa	पापा	पापा
papa	पापा	पापा
paayathan	पायथन	पावन
pithan	पायथन	पिठान
python	पायथन	पीठों
paaramparik	पारंपरिक	पार्मपाक्ष
paramparik	पारंपरिक	परमपप्रिक
paranparik	पारंपरिक	परापन्किक
paardarshi	पारदर्शी	परदर्शी
pardarshi	पारदर्शी	पर्द्रीशी
paarasnaath	पारसनाथ	पार्सनाथ
parasnath	पारसनाथ	परसंंथ
parliament	पार्लियामेंट	परर्ट्रियल
paashaatya	पाश्चात्य	पाष्ट्य
pakshatya	पाश्चात्य	पक्षात्य
paschatya	पाश्चात्य	पश्चा्त
paasing	पासंग	पाजिंग
pasang	पासंग	पांंग
picka	पिका	पिका
pika	पिका	पिका
pikaa	पिका	पिका
pictures	पिक्चर्स	पिक्टर्स
pixel	पिक्सेल	पिक्सल
pig	पिग	पिग
pichhad	पिछड़	पिछड़
pichhar	पिछड़	पिछार
pichhada	पिछड़ा	पिछड़ा
pichhdaa	पिछड़ा	पिछड़ा
pichhadi	पिछड़ी	पिछड़ी
pichhdi	पिछड़ी	पिछड़ी
pichhaddepan	पिछड़ेपन	पिचानेदावन
pichhadepan	पिछड़ेपन	पिचानेदन
pichhdepann	पिछड़ेपन	पिचेशावन
pichheti	पिछेती	पिछड़ती
peer	पियर	पेर
pier	पियर	पिरर
piyar	पियर	पियर
piere	पियरे	पिरे
pierre	पियरे	पिररे
piyare	पियरे	पिरारे
piro	पिरो	पिरो
pilaakar	पिलाकर	पिलाकार
pilakar	पिलाकर	पिलाकार
pet	पीईटी	पेट
pit	पीईटी	पिट
pgi	पीजीआई	पीजीी
pds	पीडीएस	पड्सीसी
peene	पीने	पेने
pine	पीने	पिने
pipaaji	पीपाजी	पिपाजी
pipaji	पीपाजी	पिपाजी
pipipi	पीपीपी	पिप्पी
ppp	पीपीपी	पीपीपी
pucl	पीयूसीएल	पुक्
peace	पीस	पीस
peeskar	पीसकर	पेस्कार
piskar	पीसकर	पिस्कार
pcr	पीसीआर	पीकर
putalon	पुतलों	पुटालों
putlon	पुतलों	पुटलों
pute	पुते	पुटे
punar	पुनर	पूनर
punaraavlokan	पुनरावलोकन	पूनर्वाक्कन
punaravalokan	पुनरावलोकन	पूनर्वाक्काण
punravalochan	पुनरावलोकन	पुनर्वर्चन
pushkar	पुष्कर	पुष्कार
pushpiy	पुष्पीय	पुष्पी
pushpiya	पुष्पीय	पुष्पिया
poochhanaa	पूछना	पूछना
poochhnaa	पूछना	पूछना
puchna	पूछना	पुछना
poojyaneey	पूज्यनीय	पूज्यानीय
poojyaneeya	पूज्यनीय	पूज्यानीय
pujyaniy	पूज्यनीय	पुज्यानी
poorana	पूराना	पूराण
puraanaa	पूराना	पूर्णा
purana	पूराना	पूर्ण
pus	पूस	पूस
puss	पूस	पुस्स
peticot	पेटीकोट	पेटेक्ट
petikot	पेटीकोट	पेटिकिक
petticoat	पेटीकोट	पेटेक्टिक्ट
petroleum	पेट्रोलियम	पेटररोलियम
penalty	पेनल्टी	पेनेट्यी
peninsula	पेनिनसुला	पेनेशनिया
paperwait	पेपरवेट	पापवेव्त
paperweight	पेपरवेट	पाप्रविविट
peptide	पेप्टाइड	पेप्टिड
payroll	पेरोल	पायोरलल
peyroll	पेरोल	पर्रोलल
panth	पैंठ	पंठ
penth	पैंठ	पेंठ
packaging	पैकेजिंग	पैकिंग
paidaish	पैदाईश	पैदाश
pairodi	पैरोडी	पैरोदी
parody	पैरोडी	परोद्य
perodi	पैरोडी	पेरोड़ी
paishachi	पैशाची	पैश्ची
polish	पॉलिश	पोलिश
pavel	पॉवेल	पावल
powell	पॉवेल	पॉवरल
pongal	पोंगल	पंगल
potash	पोटाश	पोत्ष
pork	पोर्क	पोर्क
posalia	पोसालिया	पोस्ीय
posaliya	पोसालिया	पोस्ीया
posted	पोस्टेड	पोस्टेड
poha	पोहा	पोहा
paun	पौन	पौन
pauna	पौना	पौना
prakriyaon	प्रक्रियाओं	प्रक्रियाओं
prakshalan	प्रक्षालन	प्रक्षण
prakshepit	प्रक्षेपित	प्रक्षिष्ट
prakhand	प्रखंड	प्रखंंड
pragatisheel	प्रगतिशील	प्रगाश्शीत
pragatishil	प्रगतिशील	प्रग्रशित
pratadna	प्रताड़ना	प्रताना
pratapgarh	प्रतापगढ़	प्रत्पााार
prati	प्रति	प्रति
prti	प्रति	प्रति
pratikraman	प्रतिक्रमण	प्रतिक्राण
pratikramana	प्रतिक्रमण	प्रतिक्रमाण
pratikriyasheel	प्रतिक्रियाशील	प्रतिक्षेर्यार
pratikriyashil	प्रतिक्रियाशील	प्रतिक्षार्याली
prtikriyashil	प्रतिक्रियाशील	प्रतियाधिकाष्य
pratigyaon	प्रतिज्ञाओं	प्रतिगायां
prtigyaon	प्रतिज्ञाओं	प्रतियोगयां
pratinidhatva	प्रतिनिधत्व	प्रतिय््थववित
pratinidhitva	प्रतिनिधत्व	प्रतिय्मद्धिथ
prtinidhtv	प्रतिनिधत्व	प्रतिं्ध्व्व
pratinidhigan	प्रतिनिधिगण	प्रतियोधिदान
pratinidhigana	प्रतिनिधिगण	प्रतियोध्धानान
prtinidhigan	प्रतिनिधिगण	प्रतियोद्धान
pratinidhitva	प्रतिनिधित्व	प्रतिय्मद्धिथ
prtinidhitv	प्रतिनिधित्व	प्रतिद्धिव्व
prativadiyon	प्रतिवादियों	प्रतिवादियों
pratishodh	प्रतिशोध	प्रतिष्ध
pratishthanon	प्रतिष्ठानों	प्रतिष्ठाओं
pratispardha	प्रतिस्पर्द्धा	प्रतिस्पावाद
pratispardhaein	प्रतिस्पर्धाएं	प्रतिवाश्वापनी
pratispardhayein	प्रतिस्पर्धाएं	प्रतिवाश्वापन
pratispardhayen	प्रतिस्पर्धाएं	प्रतिवाश्वापन
pratyangira	प्रत्यंगिरा	प्रत्योनिरार
prabhaavanaa	प्रभावना	प्रभावना
prabhavana	प्रभावना	प्रभावना
prabhaavshil	प्रभावशील	प्रभावशाल
prabhavshil	प्रभावशील	प्रभावशील
prabhaas	प्रभास	प्रभास
prabhas	प्रभास	प्रभास
pramod	प्रमोद	प्रमोड
pravritt	प्रवृत्त	प्रवृत्त
pravrut	प्रवृत्त	प्रवृत
pravrutt	प्रवृत्त	प्रवृत्त
prashaasan	प्रशासन	प्रशासन
prashasan	प्रशासन	प्रशासन
prashikshuon	प्रशिक्षुओं	प्रशिकोषकों
prasanskrat	प्रसंस्कृत	प्रसननास्थ्र
prasanskrit	प्रसंस्कृत	प्रस्नात्््र
prasanskrut	प्रसंस्कृत	प्रस्नात्र्ष
prastaav	प्रस्ताव	प्रस्तवव
prastav	प्रस्ताव	प्रस्तवव
prastaavit	प्रस्तावित	प्रस्तावित
prastavit	प्रस्तावित	प्रस्त्वित
prastuti	प्रस्तुति	प्रस्तुति
pra	प्रा	प्र
praa	प्रा	प्रा
primary	प्राइमरी	प्रमारीय
praachinatam	प्राचीनतम	प्राच््मम
pracheenatam	प्राचीनतम	प्रचेत्मम
prachintam	प्राचीनतम	प्राच्यम
praniyon	प्राणियों	प्रणियों
pradhyapak	प्राध्यापक	प्राध्यप्क
praptakarta	प्राप्तकर्ता	प्रपात््रता
praptkarta	प्राप्तकर्ता	प्रपत्््रा
praptiyon	प्राप्तियों	प्रपत्रियों
praroopon	प्रारूपों	प्रूपों
prarupon	प्रारूपों	प्रपूर्ण
pravidhik	प्राविधिक	प्रयोधिक
prince	प्रिंस	प्रिंस
princeli	प्रिंसली	प्रिंसिली
princely	प्रिंसली	प्रिंसिल्
princle	प्रिंसली	प्रिंसल
preist	प्रीस्ट	प्रेस्ट
priest	प्रीस्ट	प्रिस्ट
prist	प्रीस्ट	प्रेस्ट
prekshak	प्रेक्षक	प्रेक्षक
premji	प्रेमजी	प्रेमजी
premanand	प्रेमानंद	प्रेमेंदर
process	प्रॉसेस	प्रोकेस्स
pro	प्रो	प्रो
progressive	प्रोग्रेसिव	प्रोफ्सेवर्व
project	प्रोजैक्ट	प्रोजेक्ट
protocol	प्रोटोकोल	प्रोटोकोल
produce	प्रोड्यूस	प्रोडोक्स
producer	प्रोड्यूसर	प्रोडक्ोर
property	प्रोपर्टी	प्रोप्रेट
profesion	प्रोफेशन	प्रोफिशन
profession	प्रोफेशन	प्रोफिेशन
promot	प्रोमोट	प्रोमोंट
promote	प्रोमोट	प्रोमिट
promotional	प्रोमोशनल	प्रोमोटिनम
prospects	प्रोस्पेक्टस	प्रोस्टेप्स
prospectus	प्रोस्पेक्टस	प्रोस्टेप्स
plug	प्लग	प्लुग
plak	प्लाक	प्लेक
platinum	प्लेटिनम	प्लेटनियम
planon	प्लेनों	प्लोनों
plenon	प्लेनों	प्लेनों
plot	प्लॉट	प्लोट
function	फंक्शन	फंक्शन
fundon	फंडों	फंडों
funds	फंड्स	फंड्स
fantasi	फंतासी	फांत्सी
fantasy	फंतासी	फांट्सी
fakharpur	फखरपुर	फफ़पूर्व
fatafat	फटाफट	फतत्त
fate	फटे	फाे
phate	फटे	फाते
phte	फटे	फाे
farar	फरार	फरर
pharar	फरार	फररर
farishey	फरिश्ते	फरीषे
farishte	फरिश्ते	फरीष्ट
farishtey	फरिश्ते	फरीष्ट
faldayak	फलदायक	फलकायक
phaldayak	फलदायक	फलकायक
farming	फार्मिंग	फर्मिंग
faalna	फालना	फालना
falna	फालना	फलनना
fascist	फासिस्ट	फास्टिस्ट
fasist	फासिस्ट	फास्त्स
fastfood	फास्टफूड	फास्तुर्ड
fingers	फिंगर्स	फिंपर्स
fija	फिजा	फिजा
fiza	फिजा	फिज़ा
fizaa	फिजा	फिझा
fifteen	फिफ्टीन	फिफाइन
firki	फिरकी	फिर्की
filmana	फिल्माना	फिल्माना
fisal	फिसल	फिसल
fisle	फिसले	फाइसल
fisley	फिसले	फिस्
feeka	फीका	फेका
fika	फीका	फिका
fikaa	फीका	फिका
feed	फीड	फेड
fu	फु	फू
phoo	फु	फू
footbal	फुटबल	फोटाबल
football	फुटबल	फोंटालल
futbal	फुटबल	फुटबल
furtili	फुर्तीली	फुर्तिली
fenkane	फेंकने	फेंकने
fenkne	फेंकने	फेंकें
phenkane	फेंकने	फेंकने
fentan	फेंटम	फेंटन
phantom	फेंटम	फांत्म
fefade	फेफड़े	फेफाे
fefden	फेफड़े	फेफेंड
fame	फेम	फमे
fem	फेम	फीम
fallopian	फेलोपिन	फलोपोियां
fallopine	फेलोपिन	फलफ्रिन
felopin	फेलोपिन	फेलिपिन
falton	फेल्टन	फलोतों
feltan	फेल्टन	फेल्टन
felton	फेल्टन	फेल्टन
faij	फैज	फाजज
faiz	फैज	फाज
faiji	फैजी	फैजी
faizi	फैजी	फैज़ी
fabric	फैब्रिक	फबर्बो
fairi	फैरी	फैरी
fairy	फैरी	फैर्य
pheri	फैरी	फेरी
fail	फैल	फैल
failata	फैलता	फैलाता
failataa	फैलता	फैलाता
failta	फैलता	फैलता
failaayen	फैलाएं	फैलाएं
failaen	फैलाएं	फैलाएं
failayen	फैलाएं	फैलाएं
failaakar	फैलाकर	फ़ाकाकार
failakar	फैलाकर	फ़ालकार
fashionable	फैशनबल	फाशीनुमी
file	फॉइल	फिले
foil	फॉइल	फॉयल
fault	फॉल्ट	फाल्ट
flat	फॉल्ट	फ्लाट
fog	फोग	फाइज
fobiya	फोबिया	फोइबिया
phobia	फोबिया	फोइबिया
fuse	फ्यूज	फूस
funeral	फ्यूनरल	फंरेे
franchise	फ्रैंचाइज	फ्रेंसेह
flint	फ्लिंट	फ्लेंट
flintoff	फ्लिंटॉफ	फ्लिंफ्र्ट
flax	फ्लेक्स	फ्लेक्स
flex	फ्लेक्स	फ्लेक्स
flower	फ्लॉवर	फ्लोवर
bangla	बंग्ला	बंगला
banji	बंजी	बांजी
bungee	बंजी	बंगी
bandal	बंडल	बंंडल
bundle	बंडल	बंडल
bandhu	बंधु	बंधू
bambe	बंबे	बांबे
bombay	बंबे	बोमेब
bakra	बक्र	बकरा
baks	बक्स	बकस
baksa	बक्स	बकसा
baksar	बक्सर	बकसार
buxar	बक्सर	बकर्कर
bakson	बक्सों	बकसों
bakharband	बख्तरबंद	बखलाबंद
bakhtarband	बख्तरबंद	बख़ांडबंग
bagair	बग़ैर	बगरर
bager	बग़ैर	बगर
bagaawati	बगावती	बगावती
bagavati	बगावती	बगवती
bageecha	बगीचा	बागीचा
bagicha	बगीचा	बागीचा
bachata	बचता	बचाता
bachta	बचता	बच्ता
bachtaa	बचता	बच्ता
bachate	बचते	बचाते
bachte	बचते	बच्ेे
bachaayen	बचाएं	बचाएं
bachaen	बचाएं	बचाएं
bachayen	बचाएं	बचाएं
bachayn	बचाएं	बचाएं
bachaye	बचाये	बचाए
bacchan	बच्चन	बच्छों
bachchan	बच्चन	बच्छाण
bacchon	बच्चों	बचकों
bachchon	बच्चों	बच्छों
bachhon	बच्चों	बचों
bajrang	बजरंग	बजगंंज
bajaai	बजाई	बजाई
bajai	बजाई	बजाई
bajaanaa	बजाना	बजाना
bajana	बजाना	बााना
baggika	बज्जिका	बगगीका
bajjika	बज्जिका	बजजीका
badha	बढ़ा	बढ़ा
badhaayen	बढ़ाएं	बढ़ाएं
badhaen	बढ़ाएं	बढ़ाएं
badhayen	बढ़ाएं	बढ़ाएं
badhaani	बढ़ानी	बढ़ानी
badhani	बढ़ानी	बढ़ानी
baataungaa	बताऊंगा	बाटुगान
bataunga	बताऊंगा	बतुंगा
bataaegi	बताएगी	बतागे
bataayegi	बताएगी	बताएगी
bataegi	बताएगी	बतुएगी
batayegi	बताएगी	बतुएगी
bataashaa	बताशा	बशाा
batasha	बताशा	बशाा
badkismat	बदकिस्मत	बदकेक्तम
badami	बदामी	बदमी
badh	बध	बाध
badhaaiya	बधाईयां	बढ़ाया
badhaaiyaan	बधाईयां	बढ़ाएं
badhaeiyan	बधाईयां	बढ़ाएं
badhaiya	बधाईयां	बढ़ाया
badhiya	बधिया	बढ़िया
badhiyaa	बधिया	बढ़िया
banakata	बनकटा	बनाकता
bankata	बनकटा	बनकता
banvaaye	बनवाए	बनवाय
banvae	बनवाए	बनवाए
banvaye	बनवाए	बनवाए
banaabat	बनाबट	बनाबत
banabat	बनाबट	बनाबत
bnabat	बनाबट	बनाबत
baniae	बनिए	बनेनाई
banie	बनिए	बने
baniye	बनिए	बनेय
baniyan	बनियान	बनियां
bani	बनी	बनी
bano	बनो	बनो
babita	बबिता	बाबिता
babeena	बबीना	बबनना
babina	बबीना	बाबिना
barghat	बरघाट	बार्घ
barsate	बरसाते	बरस्ते
barsatein	बरसाते	बरससतें
barsana	बरसाना	बरसना
baramadon	बरामदों	बर्बादों
baramdon	बरामदों	बर्बों
bari	बरी	बारी
baretha	बरेठा	बरेहा
bretha	बरेठा	बृथा
bareilly	बरेली	बरेीली
bareli	बरेली	बरेली
barkali	बर्कली	बरकली
barklee	बर्कली	बर्ली
barre	बर्रे	बररे
burre	बर्रे	बर्र
balheen	बलहीन	बालीन
balhin	बलहीन	बालीन
balaat	बलात	बलात
balat	बलात	बल्त
bali	बली	बाली
balauda	बलौदा	बलादा
balki	बल्की	बाक्की
bulki	बल्की	बुल्की
bavandar	बवंडर	बवांदार
bavander	बवंडर	बवांदर
bawandar	बवंडर	बवांदर
basai	बसई	बसाई
basaav	बसाव	बसवा
basav	बसाव	बसव
baseda	बसेड़ा	बासेदा
bastar	बस्तर	बस्तर
baster	बस्तर	बस्तर
basta	बस्ता	बस्ता
bastiya	बस्तियां	बसस्ताया
bastiyan	बस्तियां	बसस्तियां
baste	बस्ते	बस्ते
bahroad	बहरोड़	बहरोो
bahrod	बहरोड़	बहरोद
bahate	बहाते	बहते
bahadurpur	बहादुरपुर	बहुपुर्वर
bahirana	बहिराणा	बहरीना
bahuvachan	बहुवचन	बहुंचन
bangla	बांग्ला	बंगला
bantate	बांटते	बंंटे
binder	बाइंडर	बिंडर
baik	बाईक	बैक
bike	बाईक	बाइक
bagara	बागरा	बाारा
bagaraa	बागरा	बगारा
bagra	बागरा	बगरा
baaga	बागा	बागा
baga	बागा	बगा
baaghi	बागी	बागी
bagi	बागी	बगगी
baagon	बागों	बागों
bagon	बागों	बागों
badhin	बाघिन	बाधीन
baghin	बाघिन	बागीन
batala	बाटला	बतला
batla	बाटला	बतला
babari	बाबरी	बबारी
babri	बाबरी	बबरी
biotech	बायोटेक	बियोक्च
barahon	बारहों	बारहों
barhon	बारहों	बारों
bariya	बारिया	बरिया
balaein	बालाएं	बलाएं
balaen	बालाएं	बलाएं
balayan	बालाएं	बलायां
balaon	बालाओं	बलाओं
baalaachandar	बालाचंदर	बालांदार
balachandar	बालाचंदर	बलाचंदार
balasahab	बालासाहब	बल्शाबा
balasaheb	बालासाहब	बल्शबाब
baltic	बाल्टिक	बाल्टिक
baltik	बाल्टिक	बल्किक
baalyakaal	बाल्यकाल	बाल्यकाल
balyakal	बाल्यकाल	बल्कालय
balykal	बाल्यकाल	बल्काल
bikharane	बिखरने	बिखारने
bikharne	बिखरने	बिखारे
bikhrane	बिखरने	बिखााने
bitta	बिट्टा	बित्ता
bitaate	बिताते	बिताते
bitate	बिताते	बिताते
bitaayaa	बिताया	बिताया
bitaya	बिताया	बिताया
birjiya	बिरजिया	बिरिजाया
birsa	बिरसा	बिरसा
birsinghpur	बिरसिंहपुर	बिरिंपपुर्
bilkul	बिल्कुल	बिलकुल
bisht	बिष्ट	बिष्ट
bisauli	बिसौली	बिसुली
being	बीइंग	बेंग
bsl	बीएसएल	बीएसलल
beacon	बीकन	बीकों
beeken	बीकन	बीकें
bikan	बीकन	बिकान
bds	बीडीएस	एडडीसी
bdsm	बीडीएसएम	एडसीएमएम
bimit	बीमित	बिमित
bujhati	बुझती	बुझाती
buzati	बुझती	बुजाती
butati	बुटाटी	बुटाती
budhana	बुढ़ाना	बुधना
buddhi	बुद्धि	बुद्धी
bulldozer	बुलडोजर	बुल्वोर्ड
buldhana	बुलढाना	बुलधना
bulakar	बुलाकर	बुलकार
buliyan	बुलियन	बुलियां
buliyn	बुलियन	बुलियां
bullion	बुलियन	बलियों
bulls	बुल्स	बल्ल
buls	बुल्स	बूल्स
beimaani	बेइमानी	बेमानी
beimani	बेइमानी	बेमनी
baig	बेग	बैग
beg	बेग	बेग
betool	बेतूल	बेटोल
betul	बेतूल	बेटलल
babe	बेब	बबबे
bemisaal	बेमिसाल	बेमाइशाल
bemisal	बेमिसाल	बेमिशुल
belt	बेल्ट	बेल्ट
belton	बेल्टों	बेलिटों
belts	बेल्ट्स	बेल्ट
besara	बेसरा	बेसारा
besraa	बेसरा	बेसरा
basinon	बेसिनों	बसियों
besinon	बेसिनों	बेसियों
basis	बेसिस	बासिस
besis	बेसिस	बेसिस
besure	बेसुरे	बेसरे
banch	बैंच	बांच
bench	बैंच	बेंच
baikunth	बैकुंठ	बैखंठ
baichen	बैचेन	बैचें
bechain	बैचेन	बेचाएं
bechen	बैचेन	बेचें
batman	बैटमैन	बतमान
baitha	बैठा	बैठा
baithaa	बैठा	बैठा
bain	बैन	बैन
ban	बैन	बान
bainet	बैनेट	बैनेंट
bennett	बैनेट	बेनेंटट
bail	बैल	बैल
bell	बैल	बेल
bailey	बैली	बैले
belly	बैली	बेली
bailon	बैलों	बैलों
bahr	बैहर	बहर
baihar	बैहर	बैहर
boxeron	बॉक्सरों	बोल्शन
batham	बॉथम	बाठम
bathem	बॉथम	बाथेम
botham	बॉथम	बोथम
boil	बॉयल	बोल
boyal	बॉयल	बोयर
boyle	बॉयल	बोयल
boiler	बॉयलर	बोयर
boyler	बॉयलर	बोयर
bodein	बोडेन	बोड़ने
boden	बोडेन	बोड़न
botheil	बोथेल	बोथेल
bothel	बोथेल	बोथेल
bodhgaya	बोधगया	बोधगाया
bodhgya	बोधगया	बोधग्य
bofors	बोफोर्स	बॉफर्स
boro	बोरो	बोरो
boron	बोरोन	बोरों
bordo	बोर्दो	बोर्डो
borno	बोर्नो	बोर्नों
bola	बोला	बोला
bolero	बोलेरो	बोल्बर
bowlero	बोलेरो	बोल्बर
bostan	बोस्टन	बोस्टन
boston	बोस्टन	बोस्टों
brahamini	ब्रह्माणी	ब्रह्मिणी
brahmani	ब्रह्माणी	ब्रह्मणी
bridesmaid	ब्राइड्समेड	ब्रिबेंडियर
bridesmaids	ब्राइड्समेड	ब्रेंसंडिय्स
brai	ब्राई	ब्राई
brie	ब्राई	ब्री
bradley	ब्रेडले	ब्रदेे
bradley	ब्रैडली	ब्रदेे
bradli	ब्रैडली	ब्रद्ी
bro	ब्रो	ब्रो
broking	ब्रोकिंग	ब्रोकिंग
bromavich	ब्रोमविच	ब्रांडवर्ध
bromvich	ब्रोमविच	ब्रांमिक्ध
bromwitch	ब्रोमविच	ब्रांमिट
bluetooth	ब्लूटूथ	ब्लुटू
bloggaron	ब्लॉगरों	ब्लगगडोों
bloggeron	ब्लॉगरों	ब्लोगोरों
bluetooth	ब्ल्यूटूथ	ब्लुटू
bhante	भंते	भांते
bhagavad	भगवद	भगवाद
bhagvad	भगवद	भागवाद
bhanak	भनक	भानक
bhayatur	भयातुर	भयुत्र
bhayaanak	भयानक	भयानक
bhayanak	भयानक	भयांक
bharat	भरत	भररत
bharata	भरता	भररता
bharataa	भरता	भररता
bharta	भरता	भर्ता
bharati	भरती	भरती
bharti	भरती	भर्ती
bharsak	भरसक	भरस्क
bharai	भराई	भाराई
bhavae	भवाई	भावाई
bhavai	भवाई	भवाई
bhavishyavaaniyaan	भविष्यवाणियां	भािष्यववियाय
bhavishyavaniyan	भविष्यवाणियां	भािष्यववीयां
bhavishyavaaniyon	भविष्यवाणियों	भािष्यववियों
bhavishyavaniyon	भविष्यवाणियों	भािष्यववियों
bhasin	भसीन	भासिन
bhau	भाऊ	भौ
bhakri	भाकरी	भक्री
bhaagate	भागते	भागते
bhagate	भागते	भगाते
bhagirathi	भागीरथी	भगबरती
bhaagya	भाग्य	भाज्य
bhagy	भाग्य	भाग्य
bhagya	भाग्य	भाग्य
bhabhi	भाभी	भाभी
bhaar	भार	भार
bhar	भार	भर
bhale	भाले	भाले
bhalekar	भालेकर	भालेकर
bhavnaein	भावनाएं	भवनाएं
bhavnaen	भावनाएं	भवाने
bhavnayn	भावनाएं	भवनाएं
bhaskaran	भास्करन	भक्करण
bhaskran	भास्करन	भक््करण
bhilala	भिलाला	भिलाा
bheetar	भीतर	भीतार
bhitar	भीतर	भित्र
bheetari	भीतरी	भीतारी
bhitari	भीतरी	भित्री
bhitri	भीतरी	भित्री
bheer	भीर	भीर
bhir	भीर	भीर
bhugatata	भुगतता	भुगताता
bhugatta	भुगतता	भुग्तता
bhugtata	भुगतता	भुगताता
bhugatana	भुगतना	भूगताना
bhugtna	भुगतना	भूग्नता
bhgti	भुगती	भेगती
bhugati	भुगती	भुगती
bhugti	भुगती	भुगती
bhuj	भुज	भुज
bhulaakar	भुलाकर	भुलाकार
bhulakar	भुलाकर	भुलकार
bhookhaa	भूखा	भूखा
bhukha	भूखा	भुखा
bhukhaa	भूखा	भुखा
bhookhe	भूखे	भूखे
bhukhe	भूखे	भुखे
bhookhon	भूखों	भूखों
bhukhon	भूखों	भूखों
bhoochaal	भूचाल	भूचल
bhuchal	भूचाल	भुचाल
bhootha	भूतहा	भूठा
bhutaha	भूतहा	भूतावा
bhuri	भूरी	भुरी
bhool	भूल	भूल
bhul	भूल	भूल
bhulate	भूलते	भूलते
bhulte	भूलते	भूतते
bhulane	भूलने	भूलने
bhulne	भूलने	भुलने
bhoosanptti	भूसंपत्ति	भूपसंपतति
bhusampatti	भूसंपत्ति	भूस्पपत्ति
bheje	भेजे	भेजे
bhejegi	भेजेगी	भेजुई
bhejogi	भेजेगी	भेजोगी
bhaiyadooj	भैयादूज	भायोदुज
bhotiya	भोटिया	भोतिया
bhaunra	भौंरा	भौरण
bhraantiya	भ्रांतिया	भ्रांत्या
bhrantiya	भ्रांतिया	भ्रस्न्य
mangvana	मंगवाना	मंगवाना
mangwana	मंगवाना	मंगवाना
mangoliyan	मंगोलियन	मानियुलायन
mongolian	मंगोलियन	मोंगियियां
manchan	मंचन	मानचन
manjili	मंजिली	मंजीली
majilein	मंजिले	मजजिन
manjile	मंजिले	मंजाली
manzile	मंजिले	मंजेली
manjilon	मंजिलों	मानिजोलों
manzilon	मंजिलों	मांजियों
manjeere	मंजीरे	मंजीरी
manjeerey	मंजीरे	मंजीरी
manjire	मंजीरे	मंजेरी
manjul	मंजुल	मंजूल
mantra	मंत्र	मान्त्र
mantrigan	मंत्रीगण	मंत्रिंग
mantron	मंत्रों	मांतरों
mantrocchar	मंत्रोच्चार	मंत्रोक्र
mantrochchar	मंत्रोच्चार	मंत्रोच्छ
manth	मंथ	मंथ
month	मंथ	मोंठ
mahanga	मंहगा	महागा
manhaga	मंहगा	मंहागा
mehnga	मंहगा	मेहनगा
makbul	मकबूल	मकबूल
maqbool	मकबूल	मकबूल
makode	मकोड़े	मकड़े
makkari	मक्कारी	मकरारी
machhua	मछुआ	मछुआ
machhuaaraa	मछुआरा	मछुराा
machhuara	मछुआरा	मछुरा
majumdar	मजूमदार	मजुमदार
mazumdaar	मजूमदार	मजबूंदार
majedaar	मजेदार	मजबूदा
majedar	मजेदार	मजबादार
mazedaar	मजेदार	मजबूदा
madiyahun	मडियाहूं	मदियाओं
mariahu	मडियाहूं	मरिहा
mariahun	मडियाहूं	मरिहाण
madhi	मढ़ी	माधी
madi	मढ़ी	माडी
matdata	मतदाता	मट्टा
matsy	मत्स्य	मात्स
matsya	मत्स्य	मत्सय
mathai	मथाई	मथाई
madad	मदद	मददा
madarason	मदरसों	मदरानों
madarson	मदरसों	मद्रों
madrason	मदरसों	मदर्सन
madde	मद्दे	माडडे
midday	मद्दे	मिड्य
madhurika	मधुरिका	मधुर्का
madhuresh	मधुरेश	मधपूर्ष
madhuban	मधुवन	मधदबन
madhuvan	मधुवन	मधधावन
madhesh	मधेश	माधेश
manmaana	मनमाना	मानमाना
manmana	मनमाना	मानमाना
manhoos	मनहूस	मनोह
manhus	मनहूस	मनहास
manaya	मनाया	मननाया
manoj	मनोज	मनोज
manonayan	मनोनयन	मनोनयां
manonyan	मनोनयन	मनोनियां
mamata	ममता	मममता
mamta	ममता	मामता
maran	मरण	मरण
maryam	मरयम	मर्मम
marathaon	मराठाओं	मरहाथों
mard	मर्द	मार्ड
malyali	मलयाली	मल्लाली
mashad	मशद	मशाद
masakaja	मसाकाजा	मासाजा
masaj	मसाज	मसाज
massage	मसाज	मससेज
masalon	मसालों	मसालों
masudanpur	मसुदनपुर	मससनुंदुर
masuri	मसूरी	मसूरी
mussoorie	मसूरी	मुस्रूरी
mahal	महल	महाल
mahakashyap	महाकाश्यप	महाक्षाा
mahakasyap	महाकाश्यप	महाकावस
mahakaushal	महाकौशल	महाकाश्
mahakoshal	महाकौशल	महाक्षक
mahaganpati	महागणपति	महागंपी
mhaganpati	महागणपति	महागंपति
mahadeshiy	महादेशीय	महादेशीय
mhadeshiy	महादेशीय	महादेशी
mahabharat	महाभारत	महाभात
mhabharat	महाभारत	महाभात
maharajaon	महाराजाओं	महागाजों
maharana	महाराणा	महानारा
mahavidhyaon	महाविद्याओं	महाविकादों
mahavidyaon	महाविद्याओं	महाविद्यों
mahashay	महाशय	महाशय
mahashaye	महाशय	महाशय
mahashamshan	महाश्मशान	महाशाशन
mahashmashaan	महाश्मशान	महाश्र्षण
mahashmshan	महाश्मशान	महाश्ष्प
mahasagar	महासगर	महासाार
mahasgar	महासगर	महासगार
mahasamadhi	महासमाधि	महासंदाही
mahina	महीना	महिना
mahesh	महेश	महह
maangta	मांगता	मांगता
mangata	मांगता	मंगता
mangta	मांगता	मंगता
maange	मांगें	मंंगे
mangein	मांगें	मांजें
mangen	मांगें	मांजें
maangon	मांगों	मांगों
mangon	मांगों	मांगों
mouth	माउथ	मूथ
madal	माडल	मदाल
model	माडल	मोडल
maandaley	माण्डले	मंंडेले
mandale	माण्डले	मंडाे
mandel	माण्डले	मंडेल
maatang	मातंग	मातंंग
matang	मातंग	मतनंग
manasik	मानसिक	मनसेक
mansik	मानसिक	मानसिक
mansikata	मानसिकता	मानसेक्ता
mansikta	मानसिकता	मानसीकता
maanegaa	मानेगा	मानेगा
manega	मानेगा	मननगगा
maapata	मापता	मापता
mapata	मापता	मापता
mapta	मापता	मपता
maape	मापे	मापे
mape	मापे	माप
maaf	माफ	माफ
maf	माफ	माफ
maarte	मारते	मार्टे
maartey	मारते	मार्टे
marte	मारते	मार्टे
maalikana	मालिकाना	मालिकाना
malikana	मालिकाना	मलिकाना
maasi	मासी	मासी
masi	मासी	मसी
masoom	मासूम	मसू
masum	मासूम	मसूम
masoomon	मासूमों	मसूसों
masumon	मासूमों	मसूमों
mahul	माहुल	महुल
mahaul	माहौल	महालू
mauritious	माॅरिशस	मॉरिप्ट्स
moreshes	माॅरिशस	मोरेेस
moresis	माॅरिशस	मोरेससस
michalaane	मिचलाने	मिचााने
michlaaney	मिचलाने	मिचलाने
michlane	मिचलाने	मिचलाने
mitaanaa	मिटाना	मिटाना
mitana	मिटाना	मिटाना
mithaaiyon	मिठाईयों	मिथाएियों
mithaiyon	मिठाईयों	मिथायों
mithilesh	मिथिलेश	मिथिशेश
mimi	मिमी	मिमी
miljulakar	मिलजुलकर	मिल्गुकार
miljulkar	मिलजुलकर	मिल्गुकार
milind	मिलिंद	मिल्ड
milibhagat	मिलीभगत	मिलभेगट
misaalein	मिसालें	मिसाएं
misale	मिसालें	मिसाले
misalein	मिसालें	मिसालें
me	मी	मे
mee	मी	मे
meeji	मीजी	मीजी
miji	मीजी	मिजी
meat	मीट	मिट
meet	मीट	मेट
medium	मीडियम	मैडियम
meeta	मीता	मीता
mita	मीता	मिटा
mungeir	मुंगेर	मुंगे
munger	मुंगेर	मंगर
munshi	मुंशी	मूंशी
moonh	मुंह	मूंढ
muh	मुंह	मह
munh	मुंह	मूं
mukesh	मुकेश	मुकेश
mukhaute	मुखौटे	मुखते
mukhautey	मुखौटे	मुखते
mukhtaar	मुख्तार	मुखरत
mukhtar	मुख्तार	मुखरत
mukhyetaar	मुख्तार	मुखबतार
mukhya	मुख्य	मुख्य
mukhye	मुख्य	मुख्य
mukhyamantritva	मुख्यमंत्रित्व	मुखमय्यवं््रि
mukhyamantriyon	मुख्यमंत्रियों	मुख्यात्रियोर्ण
mugabe	मुगाबे	मुगाबे
mugabey	मुगाबे	मुगाजे
muchalka	मुचलका	मूच्छा
muchlaka	मुचलका	मूच्छाा
muchlka	मुचलका	मूच्छा
mutthi	मुट्ठी	मूत्थि
mudane	मुड़ने	मुदने
mudne	मुड़ने	मुडने
mudit	मुदित	मुडित
mudraein	मुद्राएं	मुद्रायन
mudraen	मुद्राएं	मुद्रण
munafe	मुनाफे	मुनने
munafey	मुनाफे	मुन्मे
munaphe	मुनाफे	मुपने
munirka	मुनिरका	मुणिर्का
mursi	मुर्सी	मूर्सी
mosammi	मुसम्मी	मोसमीमी
musammi	मुसम्मी	मुस्ममी
musolini	मुसोलिनी	मुस्निलीन
mussolini	मुसोलिनी	मसस्निलिन
moo	मू	मू
mu	मू	एम
moods	मूड्स	मूड्स
mool	मूलं	मूल
mooln	मूलं	मूलन
mulam	मूलं	मूलम
moolbhoot	मूलभूत	मूच्त
mulbhoot	मूलभूत	मूलभूत
mulbhut	मूलभूत	मूलभूत
moolmantra	मूलमंत्र	मूल्मत्र
mulmantr	मूलमंत्र	मूल्मांतर
mulmantra	मूलमंत्र	मूल्माम्र्र
moolvasiyon	मूलवासियों	मूल्वियों
mulwasiyon	मूलवासियों	मूलवासियों
mulyvasiyon	मूलवासियों	मूल्यवासियों
mooli	मूली	मूली
muli	मूली	मूली
mentha	मेंथा	मेंठा
mens	मेंस	मेंस
megan	मेगान	मेगन
mejbaanon	मेजबानों	मेजबानों
mejbanon	मेजबानों	मेजबांों
mezbanon	मेजबानों	मेजबांों
menaka	मेनका	मेनका
menka	मेनका	मेंका
mera	मेरा	मेरा
meraa	मेरा	मेरा
meltan	मेल्टन	मेल्टन
melton	मेल्टन	मेल्टन
mevaadi	मेवाड़ी	मेवाड़ी
mewadi	मेवाड़ी	मेवाड़ी
mehmood	मेहमूद	मेंजोड
mehmud	मेहमूद	महंंग
mantle	मैंटल	मैंटे
mental	मैंटल	मेंटल
mandarin	मैंडरिन	माननारीन
maine	मैंने	मेन
magazine	मैगजिन	मगजानन
magzine	मैगजिन	माज़ेजी
magnus	मैगनस	मगनुस
maglev	मैगलेव	मगगवे
magnus	मैग्नस	मगनुस
magras	मैग्नस	मागरस
matric	मैट्रिक	मैट्रिक
mads	मैड्स	मादस
maitra	मैत्रा	मैत्र
matra	मैत्रा	मात्र
mankind	मैनकाइंड	मैंकिंड
maini	मैनी	मैनी
mainy	मैनी	मैन
many	मैनी	मान्य
manu	मैन्यू	मनन
menu	मैन्यू	मेनू
maiya	मैया	मैया
maiyya	मैया	मैय्य
mailkam	मैलकम	मैक्कम
malcolm	मैलकम	मैलक्म
maish	मैश	मैश
mash	मैश	माश
mesh	मैश	मेश
modular	मॉड्यूलर	मोनोुरार
modakar	मोड़कर	मोड़कर
modkar	मोड़कर	मोडकर
modate	मोड़ते	मोड़ते
modte	मोड़ते	मोड्टे
modane	मोड़ने	मोड़ने
modne	मोड़ने	मोडने
motipur	मोतीपुर	मोटिपुर
motiram	मोतीराम	मोटिनर
monal	मोनल	मोनल
monash	मोनाश	मोनाश
monitor	मोनिटर	मोनिटर
mom	मोम	मोम
morakkan	मोरक्कन	मोरककन
morkkan	मोरक्कन	मोरककन
moroccan	मोरक्कन	मोर्कोन
moravi	मोरवी	मोरवी
morvi	मोरवी	मोर्वी
morwi	मोरवी	मोर्वी
molar	मोलर	मोलर
moler	मोलर	मोल्
mola	मोला	मोला
moli	मोली	मोली
molding	मोल्डिंग	मॉल्डिंग
mohak	मोहक	मोहक
maidrik	मौद्रिक	मैद्रिक
maudrik	मौद्रिक	मौद्रिक
maureen	मौरीन	मौरीन
maurin	मौरीन	मौरीन
maurya	मौर्य	मौर्य
morya	मौर्य	मोर्य
maula	मौला	मौला
maulik	मौलिक	मौलिक
maulikata	मौलिकता	मौत्यक्त
maulikta	मौलिकता	मौतिकता
mhari	म्हारी	महारी
yateem	यतीम	यातिम
yatim	यतीम	यातिम
yadi	यदि	यादी
yashvardhan	यशवर्धन	यश्वद्धन
yathavardhan	यशवर्धन	यथाव्हवाण
yashomati	यशोमति	यश्थमी
yahi	यही	यही
yangon	यांगोन	यांगों
yatayat	यातायत	यातायत
yaar	यार	यार
yaaron	यारों	यारों
yugmon	युग्मों	यूज्यों
yunus	युनूस	यूनूस
yun	यूं	योन
uid	यूआईडी	ऐद
usda	यूएसडीए	उस्दा
utc	यूटीसी	यूटी
youth	यूथ	वोत
united	यूनाईटेड	यूनेटेड
up	यूपी	उप
ulip	यूलिप	इल्प
yulip	यूलिप	यूलिप
yale	येल	याले
yel	येल	येल
york	यॉर्क	योर्क
yogaphal	योगफल	योगफा
yogfal	योगफल	योगफर
yohaan	योहान	योहान
yohan	योहान	योहान
rangrashiya	रंगरसिया	रंग्रशाीय
rangrasia	रंगरसिया	रंग्रासिय
rangrasiya	रंगरसिया	रंग्राााय
rangaroop	रंगरूप	रंगपूर
rangarup	रंगरूप	रंगापुर
rangroop	रंगरूप	रंगरपु
rangrup	रंगरूप	रंगपुर
rangarang	रंगारंग	रंगारंंग
raeersi	रईसी	रायरीसी
raees	रईसी	रायस
raisi	रईसी	रेसी
raerson	रईसों	रार्शन
raeson	रईसों	राएं
raison	रईसों	राइसन
rakhoge	रखोगे	रखेग
rakhogey	रखोगे	रखोगे
raghukul	रघुकुल	रघुकुल
ranneetik	रणनीतिक	रणनीकित
rannitik	रणनीतिक	रणनीतिक
runner	रनर	रोनेनर
rane	रने	राने
runey	रने	रोने
rapat	रपट	रप्ट
rapton	रपटों	रप्टों
rafeek	रफीक	रफिक
rafiq	रफीक	रफ़कक
ramadan	रमदान	रामदन
ramdan	रमदान	रानदान
rasana	रसना	रसाना
rasanaa	रसना	रसाना
rasna	रसना	रसना
rasam	रसम	रासम
rasaayan	रसायन	रास्यान
rasayan	रसायन	रास्यान
rasyan	रसायन	रस्यान
rasta	रस्ता	रस्ता
rahanumaee	रहनुमाई	रहनाानु
rahnumai	रहनुमाई	रहनामाई
rhanumai	रहनुमाई	रणुमामी
riders	राइडर्स	रिडर्स
raima	राइमा	रामा
round	राउंड	रूंड
rounds	राउंड्स	रंड्स
router	राउटर	रूटर
rakesh	राकेश	रक्ष
raakh	राख	राख
rakh	राख	रख
raakhiyaan	राखियां	रख्यां
rakhiyan	राखियां	रखियां
rakhiyon	राखियों	रखियों
rakhi	राखी	रखी
raakhein	राखें	रखें
rakhen	राखें	रखें
raag	राग	राग
rag	राग	रग
raagi	रागी	रागी
ragi	रागी	रागी
raghav	राघव	राघव
raghavanand	राघवानंद	रघगवांद
raghawanand	राघवानंद	रघगवांद
rajkaran	राजकरण	रज्करण
rajtantriya	राजतंत्रीय	राजनतमात्रीय
rajdroh	राजद्रोह	राजोर्ड
rajdroha	राजद्रोह	राज्राभ
raajnetik	राजनेतिक	रामनीतिक
rajnaitik	राजनेतिक	राजनीतिक
rajnetik	राजनेतिक	राजनीतिक
rajbaag	राजबाग	राजबाग
rajbag	राजबाग	राजबाग
rajbagh	राजबाग	राजबा
rajbaug	राजबाग	रजजबब
rajendranagar	राजेंद्रनगर	रजजेंदंडर
rajya	राज्य	राज्य
raajyon	राज्यों	राजजोयों
rajyon	राज्यों	राज्यों
rathava	राठवा	रथवा
rathwa	राठवा	रथवा
raatribhoj	रात्रिभोज	रात्रोोोह
ratribhoj	रात्रिभोज	रत्वोोवों
rabiya	राबिया	राबिया
ramnaam	रामनाम	रामाान
ramnam	रामनाम	रामाम
ramsay	रामसे	रामसय
ramse	रामसे	रामसस
ramsey	रामसे	रामसे
ramayan	रामायण	रायाएं
ramayana	रामायण	रामाना
rayat	रायट	रायत
writer	रायटर	वृत्र
writter	रायटर	व्लेटर
raifal	रायफल	रेफर
rifle	रायफल	रिफरे
rifles	रायफल्स	रिफर्स
rairangpur	रायरंगपुर	रेरानपुर्
rayrangpur	रायरंगपुर	रवानपपूर्र
raashan	राशन	राशन
ration	राशन	रातियों
rashning	राशनिंग	राशनिंग
rationing	राशनिंग	रातियोगों
rashtrasant	राष्ट्रसंत	राष्ट्रप्त
tashtrasant	राष्ट्रसंत	तास्त्राष्ट
rashtriyakrit	राष्ट्रीयकृत	राष्ट्रीकृत
rashtriyekrat	राष्ट्रीयकृत	राष्ट्रिक्र्त
rashtriykrut	राष्ट्रीयकृत	राष्ट्रिकृत
reaction	रिएक्शन	रीकेशन
recover	रिकवर	रिकॉर्
recognition	रिकॉग्निशन	रिकोटिजियों
recognization	रिकॉग्निशन	रिकोटिगोजियों
recall	रिकॉल	रेकललल
rico	रिको	रिको
riko	रिको	रिको
rechards	रिचर्ड्स	रेचर्ड्स
richards	रिचर्ड्स	रिचर््स
richhpal	रिछपाल	रिफाशल
retier	रिटायर	रिटरर
retire	रिटायर	रिटरर
redael	रिडेल	रेडेल
redel	रिडेल	रेडेल
rin	रिन	राइन
reminder	रिमाइंडर	रिमेंदर
riyan	रियान	रियान
riyon	रियान	रियों
relationship	रिलेशनशिप	रेलाविं्प
revenge	रिवेंज	रेवेंज
rishton	रिश्तों	रिष्टों
rishabh	रिषभ	ऋषभ
risala	रिसाला	रिसाा
rehayashi	रिहायशी	रहस्वाषी
rihayashi	रिहायशी	रिश्वाशी
rihayshi	रिहायशी	रिश्वी
reeta	रीटा	रीता
rita	रीटा	रिता
read	रीड	रिड
reed	रीड	रिड
reading	रीडिंग	रिडोंग
redesign	रीडिजाइन	रेडेडिंग
recycling	रीसाइकलिंग	रेस्क्लिंग
restart	रीस्टार्ट	रिस्टार
ruki	रुकी	रुकी
ruko	रुको	रूको
rukavat	रूकावट	रुकावत
rukawat	रूकावट	रुकावत
roochi	रूची	रूची
ruchi	रूची	रुची
roote	रूटे	रूटे
rootey	रूटे	रूटे
rute	रूटे	रूते
roodhir	रूधिर	रूढ़िर
rudhir	रूधिर	रुधिरा
roopaeye	रूपए	रूपये
rupae	रूपए	रूपा
rupaye	रूपए	रुपये
roopkon	रूपकों	फूपों
rupakon	रूपकों	ऋपकों
rengkar	रेंगकर	रेंगार
rengagti	रेंगती	रेंगाित
rengati	रेंगती	रेंगती
rengti	रेंगती	रेंगती
registanon	रेगिस्तानों	रिजाइट्सन
razer	रेजर	राजर
razor	रेजर	राजोर
rezer	रेजर	रेजर
raging	रेजिंग	रगगंंग
razing	रेजिंग	राजिंग
rejing	रेजिंग	रिजिंग
rates	रेट्स	राटेस
rest	रेट्स	रिस्ट
raindeer	रेनडियर	रेंदरर
reindeer	रेनडियर	रिंडरर
rendear	रेनडियर	रेनेदर
revoluation	रेवोल्यूशन	रेरोटेनियन
revolution	रेवोल्यूशन	रियोट्रियन
raindi	रैंडी	रेंडी
randi	रैंडी	रंडी
rendi	रैंडी	रेंदी
rackel	रैकल	रैकल
raikal	रैकल	रेकल
rakel	रैकल	रकेल
rap	रैप	रप
rape	रैप	रपे
rapper	रैपर	रपपर
wrapper	रैपर	व्रुपर
royal	रॉयल	रोयाल
royas	रॉयस	रोयस
royce	रॉयस	रॉयो
roys	रॉयस	रोयस
ron	रोन	रोन
ronald	रोनाल्ड	रोनाड्ड
ronin	रोनिन	रोनीन
rope	रोप	रोप
ropad	रोपड़	रोपद
ropar	रोपड़	रोपर
robert	रोबर्ट	रोबरेट
roberta	रोबर्टा	रोबररता
romanch	रोमांच	रोमेंच
romanchak	रोमांचक	रोमाचक
romanchit	रोमांचित	रोमेचित
romani	रोमानी	रोमनी
romero	रोमेरो	रोमरो
roller	रोलर	रॉल्
roaster	रोस्टर	रोस्टर
roster	रोस्टर	रोस्टर
langadakar	लंगड़ाकर	लंगाकार
langarakar	लंगड़ाकर	लांगर्क
langdakar	लंगड़ाकर	लंगाकार
lambai	लंबाई	लांबाई
lanbai	लंबाई	लानबे
lambe	लंबे	लांब
lakiren	लकीरें	लकेकन
lakshamana	लक्षमण	लक्ष्णा
lakshman	लक्षमण	लक्ष्ण
laxman	लक्षमण	लक्ष्मण
lakhatkiya	लखटकिया	लखाािक
lakhtakiya	लखटकिया	लख्ाकाय
lakhanvi	लखनवी	लखनवी
lakhnavi	लखनवी	लखनववी
lakhnawi	लखनवी	लखनववी
lagaakar	लगाकर	लगाकार
lagakar	लगाकर	लगाकार
lachila	लचीली	लचेशा
lachili	लचीली	लचिली
latkaya	लटकाया	लटकाय
latkiya	लटकाया	लटकीय
ladkar	लड़कर	लड़कर
ladaakon	लड़ाकों	लड़कों
ladakon	लड़ाकों	लड़कों
lati	लती	लती
latif	लतीफ	लैटफ
labh	लभ	लाभ
laybaddh	लयबद्ध	लामदादो
lalkaar	ललकार	लाकार
lalkar	ललकार	लाकर
lalkara	ललकारा	ला्कारा
lalkare	ललकारे	ला्करे
lallu	लल्लू	लालू
lahanga	लहंगा	लहागा
lehenga	लहंगा	लेहनागा
la	ला	ला
laa	ला	ला
laanguria	लांगुरिया	लांगुरिया
languria	लांगुरिया	लंगोरिया
languriya	लांगुरिया	लंग्रिया
limestone	लाइमस्टोन	लिइमेशन
laelaaj	लाइलाज	लालाज
lailaj	लाइलाज	लेलाज
live	लाइव	लवे
life	लाईफ	लिफ
laoge	लाओगे	लाागे
laogey	लाओगे	लाएगे
laaganey	लागने	लगाने
laagne	लागने	लगने
lagne	लागने	लगने
laagu	लागु	लागू
lagu	लागु	लगो
lajimi	लाजिमी	लाजिमी
lajmi	लाजिमी	लाजममी
laate	लाते	लाटे
laatey	लाते	लाटे
late	लाते	लते
latehaar	लातेहार	लटहार
latehar	लातेहार	लटेहर
lateyhaar	लातेहार	लटेहार
laaneyvaley	लानेवाले	लानेवेवाले
lanevale	लानेवाले	लेनेवाले
lanewale	लानेवाले	लेनेवाले
lions	लायंस	लियों
lindo	लिंडो	लिंडो
likhane	लिखने	लिखने
likhne	लिखने	लिखें
liga	लिगा	लिगा
linga	लिगा	लिंगा
leader	लीडर	लेडर
leaders	लीडर्स	लेडर्स
leipzig	लीप्ज़िग	लीप्ोग
lipsing	लीप्ज़िग	लिजिपनंग
ludhka	लुढ़का	लुधाका
luthka	लुढ़का	लुठका
lubhavane	लुभावने	लुभावने
lubhawane	लुभावने	लुभावने
lubhawna	लुभावने	लुभावना
lekhon	लेखों	लेखों
letate	लेटते	लेटट
lette	लेटते	लेटट
ladies	लेडीज़	लेडिय
leti	लेती	लेटी
lenin	लेनिन	लेनिन
label	लेबिल	लेबल
lebil	लेबिल	लेबिल
lev	लेव	लेव
laigik	लैंगिक	लैगिक
laingik	लैंगिक	लैंगिक
lauch	लॉच	लौच
launch	लॉच	लौंच
lot	लॉट	लोट
lower	लोअर	लोवर
loewe	लोई	लूवे
loi	लोई	लोई
lokrang	लोकरंग	लोकरंं
logo	लोगो	लोगो
lotpot	लोटपोट	लोटप्ट
lop	लोप	लोप
lauki	लौकी	लौकी
loki	लौकी	लोकी
lautai	लौटाई	लौटाई
lautayi	लौटाई	लौटाई
vanchit	वंचित	वांछित
wanchint	वंचित	वांचित
wonders	वंडर्स	वॉड्रेस
vanshavadi	वंशवादी	वंशावादी
vanshvaadi	वंशवादी	वंशावादी
vanshvadi	वंशवादी	वंशावादी
vanshwadi	वंशवादी	वंशावादी
vadh	वध	वाध
vanam	वनम	वााम
vart	वर्ट	वार्ट
vert	वर्ट	वेर्ट
varnawal	वर्णवाल	वर्णवाल
varnvaal	वर्णवाल	वर्णवाल
varnval	वर्णवाल	वर्णवाल
vartika	वर्तिका	वार्तिका
varnaa	वर्ना	वर्ना
verna	वर्ना	वेरना
varshabhar	वर्षभर	वर्षभा
varshbhar	वर्षभर	वर्षाा
varsha	वर्षा	वर्षा
varshaa	वर्षा	वर्षा
warsha	वर्षा	वर्षा
vahneeye	वहनीय	वहनीय
vahniy	वहनीय	वहनीय
wahniy	वहनीय	वहनीय
vaanchoo	वांचू	वंचू
vanchu	वांचू	वंचू
wanchu	वांचू	वंचू
vice	वाइस	विस
vise	वाइस	विस
wice	वाइस	विस
waters	वाटर्स	वैटर्स
vadakon	वादकों	वादकों
wadkon	वादकों	वादकों
violin	वायलिन	वियोलीन
varvik	वारविक	वार्विक
warwick	वारविक	वार्विक
variyar	वारियर	वरियार
warrior	वारियर	वररोयर
valekum	वालेकुम	वालेकुम
walaikum	वालेकुम	वालिककम
walecum	वालेकुम	वालेकेम
walekum	वालेकुम	वालेकुम
vasiyon	वासियों	वसीयों
wasion	वासियों	वासियों
vastavikta	वास्तविकता	वस्तविक्ता
vastvikata	वास्तविकता	वस्त्या्य
vaahi	वाही	वाही
vahi	वाही	वही
winters	विंटर्स	विंटर्स
vindhyachal	विंध्याचल	विंध्याचाल
vikalp	विकल्प	विकापर
wicketon	विकेटों	विकेटन
victoria	विक्टोरिया	विक्टियर
vicharane	विचारने	विचारने
vicharne	विचारने	विचारने
vigyaaniyon	विज्ञानियों	विज्ञानियों
vigyaniyon	विज्ञानियों	विज्ञानियों
wisden	विज्डन	विस्दें
wizdon	विज्डन	विज्दों
vidaya	विद्या	विद्य
vidhya	विद्या	विद्य
vidya	विद्या	विद्य
vidhigya	विधिज्ञ	विधियाग्य
vidhvans	विध्वंस	विधावन
vinivesh	विनिवेश	विनेश्वर
vinegar	विनेगर	विनेजर
vinni	विन्नी	विन्नी
vinny	विन्नी	विन्ने
vipreet	विपरीत	विपर्ति
viprit	विपरीत	विप्रित
vimen	विमेन	विमें
women	विमेन	वॉमें
viral	विरल	विराल
viraag	विराग	विराग
virag	विराग	विराग
virodhabhas	विरोधाभास	विराधापाध
virodhiyon	विरोधियों	विरोधियों
vividha	विविधा	विविधा
vividhikaran	विविधीकरण	विविधार्करण
visheshaadhikaaron	विशेषाधिकारों	विशाषाधिकारों
visheshadhikaron	विशेषाधिकारों	विशाषिकारोों
vishleshan	विश्लेषण	विश्लेषण
vishleshanatmak	विश्लेषणात्मक	विश्कात्यकमक
vishleshnatmak	विश्लेषणात्मक	विश्कात्यकमक
vishleshan	विश्लेषणों	विश्लेषण
vishleshanon	विश्लेषणों	विश्लकारों
vishwabhar	विश्वभर	विश्वाार
vishva	विष्व	विश्व
vishwa	विष्व	विश्व
visangar	विसनगर	विजानगर
visnagar	विसनगर	विजाननार
week	वीक	वेक
veenus	वीनस	विनुस
venus	वीनस	विनुस
vns	वीनस	वसएसएस
vritt	वृत्त	वृत्त
vrut	वृत्त	व्रूट
vrutta	वृत्त	वृत्ता
vritiyon	वृत्तियों	वृत्तियों
vrittyon	वृत्तियों	वृत्तियों
vrutiyon	वृत्तियों	वृत्तियों
vruttiyon	वृत्तियों	वृत्तियों
vegetarian	वेजीटेरियन	वेग्नेत्रण
wednesday	वेडनसडे	वेदेनेदेव्स
weds	वेड्स	वेद्स
ved	वेद	वेड
vedar	वेदर	वेदर
weather	वेदर	वेहर्
whether	वेदर	वेचेटर
vedik	वेदिक	विद्योक
vediyaan	वेदियां	विद्यां
vediyan	वेदियां	विद्यां
variant	वेरिएंट	वरीनत
waste	वेस्ट	वस्ते
west	वेस्ट	वेस्ट
wester	वेस्टर	वेस्टर
westor	वेस्टर	वेस्टर
vaigyaanikon	वैज्ञानिकों	वैग्यानिकाओं
vaigyanikon	वैज्ञानिकों	वैग्योगियाओं
vaidyaraaj	वैद्यराज	वैद्यावाज
vaidyaraj	वैद्यराज	वैद्यावाज
vaimansyata	वैमनस्यता	वैस्नाम्यता
vair	वैर	वैर
vaishno	वैष्णो	वैषों
water	वॉटर	वेटर
voice	वॉयस	वॉयस
warrior	वॉरियर	वररोयर
warrioar	वॉरीअर	वररोयरो
warrior	वॉरीअर	वररोयर
walton	वॉल्टन	वाल्टों
valter	वॉल्टर	वॉल्टर
vaulter	वॉल्टर	वाल्टर
wolter	वॉल्टर	वॉल्टर
vodka	वोडका	वोदका
venkatesh	व्यंकटेश	वेंकेश
vyankatesh	व्यंकटेश	व्या्ष्ठ
vyanktesh	व्यंकटेश	व्यं्ष्ठ
vyagrata	व्यग्रता	व्याग्रता
vyabhichari	व्यभिचारी	व्याधिकारी
vyavadhanon	व्यवधानों	व्याधावों
vyavdhanon	व्यवधानों	व्याधावों
vyavasthapak	व्यवस्थापक	व्यावसाप्त
vyavshthapak	व्यवस्थापक	व्यायाध्प्त
vyakhakar	व्याख्याकार	व्याखकर
vyakhyakar	व्याख्याकार	व्योख्यार
vyapakata	व्यापकता	व्यापक्त
vyapakataa	व्यापकता	व्यापक्त
vyapakta	व्यापकता	व्यापक्त
viewer	व्यूअर	वियूर
vratraj	व्रतराज	वृत्वव
wear	व्हेयर	वेर
where	व्हेयर	वरे
shakuntala	शकुंतला	शाकुनता
shakuntla	शकुंतला	शाकुनता
shankutla	शकुंतला	शांतुला
shakki	शक्की	शक्की
shakt	शक्त	शक्त
shatpratishat	शतप्रतिशत	शत्प्षधष्ट
shatakshi	शताक्षी	शत्क्षी
shafi	शफी	शफीी
shabe	शबे	शबे
shamoon	शमून	शमून
shamun	शमून	शमूण
shmoon	शमून	शमून
shmun	शमून	शमून
sharfuddin	शरफुद्दीन	शररुंदगीन
sharman	शरमन	शर्मन
sharaab	शराब	शाराब
sharab	शराब	शारबो
shrab	शराब	श्रद
sharaabiyon	शराबियों	शराबियों
sharabiyon	शराबियों	शरबानियों
shrabiyon	शराबियों	श्रद्यों
sharaabi	शराबी	शाराबी
shrabi	शराबी	श्रद्बी
shararti	शरारती	शरर्ती
shrarti	शरारती	श्रद्रि
shararaton	शरारतों	शरर्ताओं
shararton	शरारतों	शरर्तों
shrarton	शरारतों	श्रोर्तों
shareer	शरीर	शरीर
sharir	शरीर	शारिर
sharirdhari	शरीरधारी	शरिद्धिरी
sharirvigyan	शरीरविज्ञान	शरियाविद्य
shariri	शरीरी	शरीरी
shariiron	शरीरों	शारियोरों
shariron	शरीरों	शरीरों
shahnawaaz	शहनवाज	शहनााज
shahnawaz	शहनवाज	शहहानज
shehnawaz	शहनवाज	शहनााज
shahar	शहर	शहह
shehar	शहर	शहर
shehr	शहर	शहर
shahariyon	शहरियों	शहरारियों
shahriyon	शहरियों	शहरियों
shaharikaran	शहरीकरण	शहर्षाकरण
shahrikaran	शहरीकरण	शहरिकरण
shehrikarn	शहरीकरण	शहक्षिणार
shaaririk	शारिरिक	शार्युक्ष
sharirik	शारिरिक	शारिरिक
shalimar	शालीमार	शालीमार
shaavaka	शावक	शावका
shavak	शावक	शावक
shaasakiya	शासकीय	शास्किया
shasakiy	शासकीय	शास्कीय
shasakiya	शासकीय	शास्किया
shaskiy	शासकीय	शास्कीय
shahjahani	शाहजहानी	शहजाानी
shikan	शिकन	शिकान
shinaakhta	शिनाख्त	शिन्भाता
shinakhat	शिनाख्त	शिन्भत
shinakht	शिनाख्त	शिन्भत
shivcharan	शिवचरण	शिवचारण
shivatv	शिवत्व	शिवाव्व
shivtv	शिवत्व	शिव्व
sheohar	शिवहर	शेयह
shivhar	शिवहर	शिवार
sheera	शीरा	शीरा
shira	शीरा	शिरा
sheershak	शीर्षक	शिराशक
shirshak	शीर्षक	शिरसक
shubhaarambh	शुभारंभ	शुभामंभ
shubharambh	शुभारंभ	शुभामंभ
shubhaashubh	शुभाशुभ	शुभभुष
shubhashubh	शुभाशुभ	शुभभूष
shubhra	शुभ्रा	शुभरा
shubra	शुभ्रा	शुब्रा
shuraat	शुरुवात	शूरत
shuruvaat	शुरुवात	शुरद्ा
shuruvat	शुरुवात	शुरुवत
shuruaati	शुरूआती	शुराती
shooker	शूकर	शूकर
shukar	शूकर	शुकर
shane	शेन	शाने
shen	शेन	शेन
shephard	शेफर्ड	शेहपाद
shepherd	शेफर्ड	शिहाप्र
sheru	शेरू	शेरू
sheruu	शेरू	शेरू
shoulder	शोल्डर	श्लार्ड
shmashaan	श्मशान	श्याषण
shmashan	श्मशान	श्याषण
shyaamdaas	श्यामदास	श्यांदवास
shyamdas	श्यामदास	श्यांदव
shraddheya	श्रद्धेय	श्रद्धाय
shradhey	श्रद्धेय	श्रद्ध
shravan	श्रावण	श्रववन
shrawan	श्रावण	श्रववन
shrota	श्रोता	श्रात
shasht	षष्ठ	शाष्ट
shashth	षष्ठ	शश््थ
sankalpana	संकल्पना	संकलपना
sanke	संके	साके
sankraanti	संक्रांति	संक्रात्ती
sankranti	संक्रांति	संक्रणति
sankhy	संख्य	संख्य
sankhya	संख्य	संख्य
sanghatan	संघठन	संझान
sanghathan	संघठन	संझान
sanghthan	संघठन	संझान
sangham	संघम	संझाम
sngham	संघम	स्पह्म
sanchay	संचय	संचाय
sanchaya	संचय	संचाय
sanchaarit	संचारित	संचार्त
sancharit	संचारित	संचर्ति
sanchaalan	संचालन	संचानन
sanchalan	संचालन	संचालन
sanjeeda	संजीदा	संजीदा
sanjida	संजीदा	संजीदा
sanju	संजू	संजू
sandarbhit	संदर्भित	संदरभित
sandrbhit	संदर्भित	संद्धभित
sandeep	संदीप	संंडी
sandip	संदीप	संंडिप
sandipa	संदीपा	संंिपा
sandehjanak	संदेहजनक	संधाननक
samposhit	संपोषित	सममपिष्ट
samprag	संप्रग	संप्रवा
sanprg	संप्रग	संपर्व
sambhalani	संभालनी	संभाननी
sambhalni	संभालनी	संभानी
samyuktataa	संयुक्तता	समयुक्तता
sanyuktata	संयुक्तता	संयुक्तता
sanyojak	संयोजक	संयोजक
sanyojakata	संयोजकता	संयोज्यता
sanyojkta	संयोजकता	संयोजिकता
samvedanheen	संवेदनहीन	संवेदेदनन
sanvedanheen	संवेदनहीन	संवेदेदनन
sanvedanhin	संवेदनहीन	संवेदेदनी
sanshay	संशय	संशाय
sanskaarit	संस्कारित	संस्कृत
sanskarit	संस्कारित	संस्कृत
sanskarita	संस्कारित	संस्कृत
sanskaaron	संस्कारो	संस्कारों
sanskaro	संस्कारो	संसाककर
sanskaron	संस्कारो	संस्कररों
sanskaaron	संस्कारों	संस्कारों
sanskaron	संस्कारों	संस्कररों
sankritnishth	संस्कृतनिष्ठ	संक्षिंचित
sanskritnisht	संस्कृतनिष्ठ	संस्कृष्ण्ंत्
sanskrutnishth	संस्कृतनिष्ठ	संस्थांष्ठ्थ्
sanskriti	संस्तुति	संस्कृति
sanstuti	संस्तुति	संस्तुती
sakal	सकल	सकल
sakling	सकलिंग	सक्लिंग
suckling	सकलिंग	सूक्लिंग
sakengi	सकेंगी	सकींगी
sachhidanandan	सच्चिदानंदन	सच्चेदाद्वन
sachidanand	सच्चिदानंदन	सच्चेदांद
satchidanandan	सच्चिदानंदन	सत्वभिद्वान
sajdhaj	सजधज	सजाभझ
sajjit	सज्जित	सजीजित
satnaam	सतनाम	सत्ताम
satnam	सतनाम	सत्काम
sattar	सत्तर	सत्तर
satyaveer	सत्यवीर	सत्याार
satyavir	सत्यवीर	सत्यवार
satya	सत्या	सत्य
satyaansh	सत्यांश	सत्वस्न
satyansh	सत्यांश	सत्यवण
sadarang	सदारंग	सद्दांग
sadashivarao	सदाशिवराव	सद्यावसार
sadashivram	सदाशिवराव	सद्यवश्रम
sadashivrao	सदाशिवराव	सद्यावसार
sunrise	सनराइज	सनरेस
sanaya	सनाया	सनाय
sani	सनी	सानी
sunny	सनी	सन्न
sapt	सप्त	सप्त
sapta	सप्त	सप्त
saptarishi	सप्तर्षि	सप््पित्री
saptarshi	सप्तर्षि	सप््प्ति
safi	सफी	सफी
sabhasad	सभासद	सभासाद
sabhyataon	सभ्यताओं	सभ्याताओं
samajhaute	समझौते	समाजेते
samjhaute	समझौते	समझते
samarthit	समर्थित	समर्थित
samrthit	समर्थित	समर्थित
samaadhanon	समाधानों	समाधानों
samadhanon	समाधानों	समाधानों
samaadhi	समाधि	समाधी
samadhi	समाधि	समाधी
samudratat	समुद्रतट	समुद्रतत
sayajirao	सयाजीराव	सायोजिरार
ssayajirao	सयाजीराव	स्पायारारो
sanrachna	सरंचना	सन्चाना
saranchana	सरंचना	सरांचना
sarakte	सरकते	सरकते
sarkte	सरकते	सरक्ते
sarkaar	सरकार	सरकार
sarkar	सरकार	सरकर
sarnobat	सरनोबत	सर्नबत
saras	सरस	सरस
sarasta	सरसता	सरस्ता
sarsata	सरसता	सर्सता
sarsta	सरसता	सर्सता
saraah	सराह	सााह
sarah	सराह	सारह
sareaam	सरेआम	सरिया
circular	सर्कुलर	सिर्कालार
sarvashaktimaan	सर्वशक्तिमान	सर्वशाक््ताओं
sarvashaktiman	सर्वशक्तिमान	सर्वशाक््ताओं
sarvshaktiman	सर्वशक्तिमान	सर्वशाक््ताओं
sarvoday	सर्वोदय	सर्वोयय
sarvodaya	सर्वोदय	सर्वोदिया
sarwoday	सर्वोदय	सर्वोयय
salwar	सलवार	सलवार
salae	सलाई	सलाई
salai	सलाई	सलाई
slaai	सलाई	स्लाई
salaahkaron	सलाहकारों	सलाहारों
salahkaron	सलाहकारों	सलाहारों
salaahiyat	सलाहियत	सलाहित्य
salahiyat	सलाहियत	सलोह्यत
savaliya	सवालिया	सविलाया
sawaliya	सवालिया	सालिया
savalon	सवालों	सवालों
sawalon	सवालों	सवालों
sashankit	सशंकित	सास्चातित
sahasansthapak	सहसंस्थापक	सहस्तापापक
sahsanstapak	सहसंस्थापक	सहस्तापक्ष
sahsansthapak	सहसंस्थापक	सहस्तापापक
sahi	सही	साही
sampradayik	सांप्रदायिक	संप्यवाहिक
sampradayika	सांप्रदायिक	संप्यवाहिका
sampradayikata	सांप्रदायिकता	संप्रविक्यता
sampradayikta	सांप्रदायिकता	संप्रविक्तता
saaj	साज	साज
saj	साज	सज
saajon	साजों	साजों
sajon	साजों	सज्जों
sajhedaar	साझेदार	सजभदार
sajhedar	साझेदार	सजभदार
sana	साना	साना
sarvabhaunik	सार्वभौमिक	सर्वभानिक
sarvbhaumik	सार्वभौमिक	सर्वभामिक
saarvabhaumikataa	सार्वभौमिकता	सर्वभानिक्त
sarvabhaumikata	सार्वभौमिकता	सर्वभानिक्त
sarvabhaumikta	सार्वभौमिकता	सर्वभानिक्त
sarvbhaumikata	सार्वभौमिकता	सर्वभानिकता
saleh	सालेह	साची
sahabon	साहबों	सहकों
sahbon	साहबों	साहों
saha	साहा	साह
sahit	साहित	सहित
sahebganj	साहिबगंज	सहजेंबंग
sahibganj	साहिबगंज	साहिजनंग
singhe	सिंघे	सिंघे
singhey	सिंघे	सिंझे
syndicate	सिंडिकेट	सिंबेट्ट
cindi	सिंडी	सिंडी
sindi	सिंडी	सिंडी
sindy	सिंडी	सिंडी
sindhughosh	सिंधुघोष	सिंधुष्ध
sindhugosh	सिंधुघोष	सिंधुप्ध
singh	सिंह	सिंघ
sinh	सिंह	सिंह
sinha	सिंह	सिंह
sikudta	सिकुड़ता	सिकुदता
sikudan	सिकुड़न	सिकुंड
sikuda	सिकुड़ा	सिकागा
sikudi	सिकुड़ी	सिकुदी
sikude	सिकुड़े	सिकेडे
sikudey	सिकुड़े	सिकुेे
sikhana	सिखाना	सिखाना
signal	सिगनल	सिगननल
signallon	सिगनलों	सिग्रालून
signalon	सिगनलों	सिग्नालों
cipla	सिपला	सीपला
simaria	सिमरिया	सिमारिया
simariya	सिमरिया	सिमारिया
simriya	सिमरिया	सिम्रिया
siyar	सियर	सियार
sirf	सिर्फ	सिर्फ
sivrej	सिवरेज	सिवर्ज
sivana	सिवाना	सिवान
siwana	सिवाना	सिवाना
sihava	सिहावा	सिहावा
cis	सीआईएस	सीआईएस
cec	सीईसी	सीसीआई
cafa	सीएफए	कफा
cfa	सीएफए	सीफीआई
cl	सीएल	कीएमएम
csir	सीएसआईआर	सीएमआईआरआई
cedan	सीडान	सेड़न
sidan	सीडान	सिद्न
sitapur	सीतापुर	सितापुर
sitarmaiya	सीतारमैया	सितारमायाई
sitarmaiyya	सीतारमैया	सितानरायय
sitarmayya	सीतारमैया	सितारमायय
seedha	सीधा	सीधा
sidha	सीधा	सिधा
sceney	सीने	स्एएनएमनी
sine	सीने	सीन
cvc	सीवीसी	सीवीसी
sehore	सीहोर	सेहरर
sihor	सीहोर	सिहोर
sung	सुंग	संग
suites	सुइट्स	सूटेस
suits	सुइट्स	सूट्स
sukama	सुकमा	सुकामा
sukma	सुकमा	सुक्मा
sukhate	सुखाते	सुखते
sugam	सुगम	सुगम
sujay	सुजय	सुजाय
sujaan	सुजान	सुजान
sujan	सुजान	सुजन
sudipta	सुदिप्ता	सुदिप्त
sudharane	सुधरने	सुधारने
sudharney	सुधरने	सुधारणे
sudhrane	सुधरने	सुधारने
sudharma	सुधर्मा	सुधारम
sudheesh	सुधीश	सुद्ध
sudhish	सुधीश	सुधिश
suneet	सुनीत	सुनेत
sunit	सुनीत	सुनीत
supernova	सुपरनोवा	सुपर्नों
sufal	सुफल	सुफर
subah	सुबह	सुभा
subeh	सुबह	सुबेड
subbarao	सुब्बाराव	सबबाबारो
subbarav	सुब्बाराव	सब्बेवाद
sumantr	सुमंत्र	सुमान्त्र
sumantra	सुमंत्र	सुमान्त्र
sumerpur	सुमेरपुर	सुमानपुर
surakshit	सुरक्षित	सूरक्षित
surkshit	सुरक्षित	सूर्चिष्ट
sooraj	सुरज	सूरज
suraj	सुरज	सुराज
surjan	सुरजन	सुर्जन
suraji	सुराजी	सुराजी
suljhaaya	सुलझाया	सुलझाया
suljhaayaa	सुलझाया	सुलझाया
suljhaya	सुलझाया	सुलझाया
suljhayaa	सुलझाया	सुलझाया
sulzaya	सुलझाया	सुलझाया
sultan	सुलतान	सूल्टन
sultana	सुलतान	सूल्ताना
sultaanon	सुलतानों	सुलाताओं
sultanon	सुलतानों	सूल्टानों
sulzanon	सुलतानों	सुलझाजों
subarna	सुवर्ण	सुबरण
suvarn	सुवर्ण	सुवारन
suvran	सुवर्ण	सूवरण
susajjit	सुसज्जित	सुसाजित
susan	सुसन	सुसन
suchakon	सूचकों	सूचकों
suchkon	सूचकों	सुचकों
suchnaen	सूचनाऐं	सूचनाएं
suchnayen	सूचनाऐं	सूचााएं
sooje	सूजे	सूजे
suje	सूजे	सुजे
sudan	सूडान	सुदान
sootak	सूतक	सूतक
sutak	सूतक	सुटक
sutrapat	सूत्रपात	सुत्त्र्
sense	सेंस	सेंस
set	सेट	सेट
setting	सेटिंग	सेट्टिंग
seton	सेटों	सेटों
setton	सेटों	सेटटन
sets	सेट्स	सेट्स
senapatitv	सेनापतित्व	सोनाप्प्त्त
senapatitva	सेनापतित्व	सोनाप्ववित
sebastian	सेबास्टियन	सेस्बाशन
sebastiyan	सेबास्टियन	सेस्सातियां
seminari	सेमिनरी	सेमोनीरी
seminary	सेमिनरी	सेमोनीरी
semi	सेमी	सेमी
seri	सेरी	सेरी
selangor	सेलांगोर	सेलांगर
celina	सेलीना	सेलिना
selina	सेलीना	सेलिना
sevak	सेवक	सेवक
sewak	सेवक	सेवक
saving	सेविंग	साविंग
sevit	सेवित	सेवित
seviyon	सेवियों	सेवियों
sesana	सेसना	सेमना
sesanaa	सेसना	सेमनना
sesna	सेसना	सेमनना
saikado	सैकडो	सैकादो
saikdo	सैकडो	सैकोड
saturn	सैटर्न	सतुर्ण
suturn	सैटर्न	सुतुर्ण
sainik	सैनिक	सैनिक
sainikon	सैनिकों	सैनिकों
socket	सॉकेट	सोकेट
song	सॉन्ग	सोंग
sochati	सोचती	सोचती
sochti	सोचती	सोचती
songara	सोनगरा	सोनगरा
sono	सोनो	सोनो
som	सोम	सोम
soman	सोमन	सोमन
soman	सोमान	सोमन
somalia	सोमालियाई	सोमायिया
somaliyai	सोमालियाई	सोमायियाई
somaiya	सोमैया	सोमाया
solahaven	सोलहवें	सोलहवें
solhaven	सोलहवें	सोलहवें
social	सोशल	सोसिलल
soshal	सोशल	सोशाल
saudon	सौदों	सौदों
sodon	सौदों	सोडों
sauhard	सौहार्द	सौहाद
sauharda	सौहार्द	सौहादा
souharda	सौहार्द	सोहाराद
scotish	स्काॅटिश	स्क्रिश
scottish	स्काॅटिश	स्क्रोटि
skip	स्किप	स्कीप
scoop	स्कूप	स्कूप
skoop	स्कूप	स्कूप
scan	स्कैन	स्केन
scanner	स्कैनर	स्केनर
skhalit	स्खलित	स्खलित
startup	स्टार्टअप	स्टार्टूप
steamer	स्टीमर	स्टीनर
stimer	स्टीमर	स्टीमर
stanley	स्टेनले	स्टाने
stallone	स्टेलोन	स्ट्रेन
standby	स्टैंडबाय	स्टंबे्व
static	स्टैटिक	स्टेक्ट
stallone	स्टैलोन	स्ट्रेन
streep	स्ट्रीप	स्ट्रीप
strip	स्ट्रीप	स्ट्रिप
stripe	स्ट्रीप	स्ट्रिप
strock	स्ट्रोक	स्ट्रोक्क
stroke	स्ट्रोक	स्ट्रोक
stanon	स्तनों	स्टोनों
stotra	स्तोत्र	स्ट्रा
stritv	स्त्रीत्व	स्ट्रिव
stritva	स्त्रीत्व	स्त्यवित
stotra	स्त्रोत्र	स्ट्रा
strot	स्त्रोत्र	स्ट्रोत
strotra	स्त्रोत्र	स्त्रोत्र
sthit	स्थित	स्थित
sthithi	स्थिति	स्थित
sthiti	स्थिति	स्थिति
sthiti	स्थिती	स्थिति
sniper	स्नाइपर	स्नेपर
snnaiper	स्नाइपर	सननेेप
spaek	स्पाइक	स्पेक
spike	स्पाइक	स्पेकी
spiderman	स्पाइडरमैन	स्पीनिर्रन
spelling	स्पेलिंग	स्पाइंगंंग
spoted	स्पॉटेड	स्नेट्ड
spotted	स्पॉटेड	स्पेट्ट
spilit	स्प्लिट	स्पिििट
split	स्प्लिट	स्पृत
smooth	स्मूथ	स्मोथ
slab	स्लैब	स्लेब
slam	स्लैम	स्लाम
svatantr	स्वतंत्र	स्वतंत्र
swatantr	स्वतंत्र	स्वतंत्र
swatantra	स्वतंत्र	स्वतंत्र
svabhav	स्वभाव	स्वभभव
swabhaav	स्वभाव	स्वभाव
swabhav	स्वभाव	स्वभभव
svabhabon	स्वभावों	स्वाभों
swabhaavon	स्वभावों	स्वाभों
swabhavon	स्वभावों	स्वाभों
swayamvar	स्वयंवर	स्वयांवर
swayanvar	स्वयंवर	स्वायनार
swarup	स्वरुप	स्वरूप
swarkal	स्वर्णकाल	स्वार्कल
swarnakaal	स्वर्णकाल	स्वानांकाल
swarnakal	स्वर्णकाल	स्वानार्क
swan	स्वां	स्वान
swang	स्वांग	स्वांग
swati	स्वाती	स्वाती
swaamiyon	स्वामियों	स्वायियों
swamion	स्वामियों	स्वामों
swamiyon	स्वामियों	स्वायियों
switched	स्विच्ड	स्विचेट
swedish	स्विडिश	स्वेद्श
swidish	स्विडिश	स्विद्ध
sweety	स्वीटी	स्वित
sweets	स्वीट्स	स्वित्स
sweeper	स्वीपर	स्विपर
sweat	स्वेट	स्वेट
swet	स्वेट	स्वेट
hansadaa	हंसदा	हंंदा
hansda	हंसदा	हंंदा
haklaate	हकलाते	हक्तते
haklate	हकलाते	हक्लते
hakka	हक्का	हकका
sakka	हक्का	सकका
hatana	हटना	हटाना
hatna	हटना	हटना
hatane	हटने	हटाने
hatne	हटने	हटने
hate	हते	हाते
hatha	हत्था	हथा
hattha	हत्था	हट्था
hatya	हत्था	हट्य
hatyaein	हत्याएं	हटवाएं
hatyaen	हत्याएं	हटवाएं
hatyayen	हत्याएं	हट्याएं
hanut	हनुत	हनूत
habshi	हब्शी	हामिशी
hubshi	हब्शी	हरेश
humdam	हमदम	हमरें
humdum	हमदम	हमेंुम
hamaad	हमाद	हमाद
hamad	हमाद	हमद
humad	हमाद	हमांड
hamirpur	हमीरपुर	हमिसपुर
hayagreev	हयग्रीव	हायाग्री
hayagreeva	हयग्रीव	हवारगग्र
hayagriva	हयग्रीव	हवारगढ़ा
haygreev	हयग्रीव	हायग्री
hardam	हरदम	हर्डम
hurdum	हरदम	हर्डोम
harad	हरदा	हरड़
harda	हरदा	हरडा
harbart	हरबर्ट	हरबर्त
harburt	हरबर्ट	हरबूर्त
herbert	हरबर्ट	जेर्डेट
haryaanavi	हरयाणवी	हर्मवान्य
haryanvi	हरयाणवी	हर््मवी
harsiddhi	हरसिध्दि	हर्सिद्धी
harsh	हर्ष	हर्श
harsha	हर्षा	हर्शा
harshik	हर्षिका	हर्शिक
harshika	हर्षिका	हर्शिका
haldighaati	हल्दीघाटी	हलाग्रिति
haldighati	हल्दीघाटी	हलाग्धिति
havas	हवस	हावस
hawas	हवस	हावस
havaen	हवाएं	हवाएं
hawayein	हवाएं	हवाएं
hawayen	हवाएं	हवाएं
havao	हवाओ	हवाओ
hawaao	हवाओ	हवाओ
hawao	हवाओ	हवाओ
havas	हवास	हावस
hawaas	हवास	हावास
hawas	हवास	हावस
haseen	हसीन	हासिन
hasin	हसीन	हासिन
hypo	हाइपो	एमजीएी
hypothalamus	हाइपोथैलेमस	एईनिप्नेम्स
hijack	हाईजैक	हिजकक
haitec	हाईटेक	हैटक
hightake	हाईटेक	हिगाते
hightech	हाईटेक	हिइडेट
hitake	हाईटेक	हिटके
hiteck	हाईटेक	हिटकक
hypertension	हाईपरटेंशन	हिइपरर्शन
houses	हाउसेस	ऑ्सेस
hathve	हाथवे	हथवे
hathway	हाथवे	हथवावे
hyman	हायमन	ह्यामन
hymen	हायमन	ह्यूमें
halia	हालिया	हलिया
haliya	हालिया	हलिया
haashmi	हाश्मी	हाश्मी
hashmi	हाश्मी	हाश्मी
hidavi	हिंदवी	हिडववी
hindavi	हिंदवी	हिंदववी
hindvi	हिंदवी	हिंडीवी
hichkichate	हिचकिचाते	हिच्चचेे
hichkichane	हिचकिचाने	हिचकेचने
hitkar	हितकर	हितकार
hindi	हिन्दी	हिंडी
hiran	हिरण	हीरन
hilakar	हिलाकर	हिलाकार
hilaal	हिलाल	हिलाल
hilal	हिलाल	हिलाल
hinsa	हिसा	हिंसा
hisa	हिसा	हिसा
hiss	हिस्स	हिसस
hissa	हिस्स	हिससा
hirachand	हीराचंद	हिरांंंड
hue	हुऐ	हुए
hujum	हुजूम	हजजमम
hood	हुड	होड
hud	हुड	हुड
hunar	हुनर	हुनार
hoon	हूँ	हून
hun	हूँ	हन
hetu	हेतु	हेतू
herald	हेराल्ड	हेराल्ड
helmet	हेल्मेट	हेलेंट
haven	हेवन	हवें
heaven	हेवन	फेवें
haidarabad	हैदराबाद	हैदाबाद
hyderabad	हैदराबाद	हाइडबबार्ड
hyderabadi	हैदराबादी	हाइडबबाड़ी
halloween	हैलोवीन	हल्लोडीन
helloveen	हैलोवीन	हेलोवाडी
haiwaan	हैवान	हावन
havan	हैवान	हवान
heyvan	हैवान	हेवन
hash	हैश	हाश
hop	हॉप	होप
hope	हॉप	होप
hopes	हॉप्स	होप्स
hops	हॉप्स	हॉप्स
halt	हॉल्ट	हाल्ट
hault	हॉल्ट	हाल्ट
hostelon	हॉस्टलों	होस्टलों
hon	हों	होन
hojri	होजरी	होजरी
hojry	होजरी	होजरी
hosiery	होजरी	होसियर
hota	होता	होता
homepage	होमपेज	होमेपेज
hold	होल्ड	होल्ड
holder	होल्डर	होल्ड
hosho	होशो	होशो
huar	ह्यूअर	ह्रू
hyuar	ह्यूअर	ह्यूरु
hyuer	ह्यूअर	हाइरो
