Input	Target (Hindi)	Prediction (Hindi)
ankan	अंकन	अंकन
angkor	अंगकोर	अंगकर
angira	अंगिरा	अंगीरा
angithi	अंगीठी	अंगीठी
angrej	अंग्रेज	अंग्रेज
angrejon	अंग्रेजों	अंग्रजों
anjaam	अंजाम	अंजाम
anjam	अंजाम	अंजाम
antakaran	अंतकरण	अंतकरण
antkaran	अंतकरण	अंतकरण
anralon	अंतरालों	अनरालों
antralon	अंतरालों	अंतरालों
antarkalah	अंतर्कलह	अंतरकालह
antarklah	अंतर्कलह	अंतरक्ला
antkalah	अंतर्कलह	अंतकालह
andher	अंधेर	अंधर
andhera	अंधेरा	अंधरा
andheraa	अंधेरा	अंधरा
andhere	अंधेरे	अंधेरे
ambar	अंबर	अंबर
amber	अंबर	अंबर
umber	अंबर	उंबर
ambarnath	अंबरनाथ	अंबरनाथ
ahankaar	अंहकार	अहंकार
ahankar	अंहकार	अहंकर
anhkar	अंहकार	अनहाकर
akaash	अकाश	अकाश
akash	अकाश	अकाश
akeelaa	अकीला	अकीला
akila	अकीला	अकिला
ankush	अकुंश	अंकुश
aksharash	अक्षरशः	अक्षरश
aksharashaah	अक्षरशः	अक्षरशा
aksharashah	अक्षरशः	अक्षरशा
asharsha	अक्षरशः	अशर्षा
akhandanand	अखंडानंद	अखंडनंद
akhbar	अखबार	अख़बा
akhabari	अखबारी	अखाबड़
akhbari	अखबारी	अख़बार
akhabaro	अखबारो	अखाबड़
akhbaro	अखबारो	अख़बार
akhabaron	अखबारों	अखाबारो
akhbaron	अखबारों	अख़बारो
akhatar	अख़्तर	अखातर
akhtar	अख़्तर	अख्तर
agar	अगर	अगर
august	अगस्त	औगस्त
agnivesh	अग्निवेश	अग्निवेश
agrata	अग्रता	अग्रता
agli	अग्ली	अगली
ugly	अग्ली	उगली
achyutanand	अच्युतानंद	अच्युतनांड
aja	अजा	अजा
atak	अटक	आतक
atka	अटका	आत्क
atkav	अटकाव	अत्कव
ataki	अटकी	आतकी
atki	अटकी	आत्क
attention	अटेंशन	एटेंशन
atarra	अतर्रा	अतररा
atrra	अतर्रा	अत्रा
adabi	अदबी	अदबी
adbi	अदबी	अडबी
aditi	अदिती	आदिती
adhikat	अधिकत	अधिकत
adhikaanshat	अधिकांशत	आधिकांशत
adhikanshat	अधिकांशत	अधिकांशत
adhikaash	अधिकाश	अधिकाश
adhikash	अधिकाश	अधिकाश
adhimaas	अधिमास	अधिमास
adhimas	अधिमास	अधिमास
ankahi	अनकही	अंकही
anake	अनके	अनाक
anke	अनके	एनके
anrasa	अनरसा	अनरास
unrasa	अनरसा	उनरास
anseekh	अनसीन	अनसीख
unseen	अनसीन	यूनसी
ansune	अनसुने	अंसुने
unsune	अनसुने	उनसूने
uncensored	अनसेंसर्ड	यूंसेंसर्
anadaran	अनादरण	अनादरण
anadarana	अनादरण	अनाडरण
aniti	अनीति	अनिती
anukool	अनुकूल	अनुकूल
anukul	अनुकूल	अनुकुल
anukulin	अनुकूलित	अनुकुलीन
anukulit	अनुकूलित	अनुकुलित
anuprayog	अनुप्रयोग	अनुप्रयोग
anuprayogi	अनुप्रयोग	अनुप्रयोग
anupryog	अनुप्रयोग	अनुप्रयोग
anubhavahin	अनुभवहीन	अनुभवहीन
anubhavheen	अनुभवहीन	अनुभवीह
anubhavhin	अनुभवहीन	अनुभवहीन
anuvaad	अनुवाद	अनुवाद
anuwad	अनुवाद	अनुवाद
anuvaadit	अनुवादित	अनुवादित
anuvadit	अनुवादित	अनुवादित
anusaran	अनुसरण	अनुसरण
anusarand	अनुसरण	अनुसरं
anusuya	अनुसूया	अनुसुया
anyatr	अन्यत्र	अन्यत्र
anyatra	अन्यत्र	अन्यत्र
anyayi	अन्यायी	अन्यायी
apnana	अपनाना	अपनाना
apamishran	अपमिश्रण	अपमिश्रण
apmishran	अपमिश्रण	अपमिश्रण
apaaramparik	अपारंपरिक	अपारंपरिक
aparamparik	अपारंपरिक	अपरामारिक
aparamprik	अपारंपरिक	अपरामप्रि
approver	अप्रूवर	अप्रोवर
aproover	अप्रूवर	अपूरेवर
afsos	अफसोस	एफ्सो
abadhit	अबाधित	अबाधित
abadhith	अबाधित	अबाधित
abul	अबुल	अबुल
abbas	अब्बास	अब्स
abhinatri	अभिनत्री	अभिनतारी
abhintri	अभिनत्री	अभिनत्री
amisha	अमीषा	अमीशा
amul	अमूल	अमूल
amod	अमोद	अमोद
amodh	अमोद	अमोध
ammoo	अम्मू	अमू
ammu	अम्मू	अम्यू
anmum	अम्मू	अनमूम
arandi	अरंडी	अरंदी
arendi	अरंडी	अरेंद
arndi	अरंडी	अर्ने
arase	अरसे	आरेस
arse	अरसे	आर्स
arastu	अरस्तू	अरस्तु
aristu	अरस्तू	आरिस्ट
arstu	अरस्तू	आर्स्ट
araamako	अरामको	आरामको
aramco	अरामको	आर्मको
aramko	अरामको	आर्कमो
araasu	अरासु	आरासु
arasu	अरासु	आरसू
arun	अरुण	आरून
arjun	अर्जुन	अर्जुन
arthatantra	अर्थतंत्र	अर्थतंत्र
arthtantr	अर्थतंत्र	अर्थतंत्र
arthtantra	अर्थतंत्र	अर्थतंत्र
arthdand	अर्थदंड	अर्थदंड
arthaniti	अर्थनीति	अर्थानित
arthneeti	अर्थनीति	अर्थनीति
arthniti	अर्थनीति	अर्थनिति
arthavyavasthaen	अर्थव्यवस्थाएं	अर्थव्यवस्थाएं
arthvyavasthayen	अर्थव्यवस्थाएं	अर्थव्यवस्थाएं
arthvyvasthayen	अर्थव्यवस्थाएं	अर्थव्यवस्थाएं
arthing	अर्थिंग	आर्थिंग
earthing	अर्थिंग	एयथरिंग
arthi	अर्थी	अर्थी
arnold	अर्नोल्ड	आर्नोल्ड
alkayada	अलकायदा	अलकायड़
alqaeda	अलकायदा	अल्केडा
alagav	अलगाव	अलगव
algaav	अलगाव	अलगाव
algav	अलगाव	अलगाव
alagaavavaada	अलगाववाद	अलगववादा
alagavavaad	अलगाववाद	अलगवावाद
alagavavada	अलगाववाद	अलगवादा
algavwaad	अलगाववाद	अलगवाद
algu	अलगू	अल्ग
alaska	अलास्का	अलाक्का
alim	अलीम	अलीम
avadh	अवध	अवध
avadhiyan	अवधियां	अवधियां
avdhiya	अवधियां	अवधिया
avdhiyan	अवधियां	अवधियां
avadhiyon	अवधियों	अवधियों
avdhiyon	अवधियों	अवधियों
avarohi	अवरोही	अवरोही
avrohi	अवरोही	अवरोही
avaran	अवर्ण	अवरण
avarn	अवर्ण	अवर्ण
avran	अवर्ण	अवरण
aawaskyakta	अवश्यकता	आवास्क्य
avashyakta	अवश्यकता	अवश्यकता
avshykata	अवश्यकता	अवश्यकता
avashyamev	अवश्यमेव	अवश्यमेव
avshymev	अवश्यमेव	अवश्यमेव
avaastvik	अवास्तविक	अवास्तविक
avastweak	अवास्तविक	अवस्तवेक
awastvik	अवास्तविक	अवस्तविक
aviv	अवीव	अविव
avyavahaarik	अव्यावहारिक	अव्यवहारिक
avyavaharik	अव्यावहारिक	अव्यवहारिक
avyavharik	अव्यावहारिक	अव्यवहारिक
ashakt	अशक्त	अशक्त
ashkt	अशक्त	अशक्त
ashasakiy	अशासकीय	अशासकीय
ashaskiye	अशासकीय	अशासकीय
ashok	अशोक	एशोक
ashoka	अशोका	आशोका
asankhy	असंख्य	असंख्य
asankhya	असंख्य	असंख्य
asangat	असंगत	असंगत
asamaantaayen	असमानताएं	असमातंतेए
asamaantayen	असमानताएं	असमांतयें
asamantae	असमानताएं	असमानता
asmantayen	असमानताएं	अस्मांतये
asar	असर	असर
asainik	असैनिक	असैनिक
asparshyataa	अस्पृश्यता	अस्पर्ष्यत
asprashyata	अस्पृश्यता	अस्पृश्यता
asprishyta	अस्पृश्यता	अस्पृश्यता
ahamiyat	अहमियत	अहमियत
ahmiyat	अहमियत	अहमियत
ahitkar	अहितकर	अहितका
aanand	आंनद	आनंद
anand	आंनद	अनंद
aansar	आंसर	आंसर
answer	आंसर	अंसव
itemon	आइटमों	इतेमों
aaina	आइना	आईना
irb	आईआरबी	आईआरबी
ieee	आईईईई	इई
ias	आईएएस	आईएस
ioc	आईओसी	आयोक
outlet	आउटलेट	आउटलेट
aau	आऊ	आऊ
aauu	आऊ	आऊ
ou	आऊ	ओ
aao	आओ	आओ
aaoo	आओ	आऊ
aakaasheeya	आकाशीय	आकाशीय
aakashiy	आकाशीय	आकाशीय
aakashiya	आकाशीय	आकाशीय
aagjani	आगजनी	आगजान
aaganan	आगणन	आगना
aagman	आगणन	आग्म
aagarkar	आगरकर	आगरका
agarkar	आगरकर	अगरकर
aachman	आचमन	आचमा
ajadnagar	आजादनगर	अजादनगर
azadnagar	आजादनगर	अजादनगर
aadambar	आडंबर	आदंबर
adambar	आडंबर	अदंबर
aadambaro	आडंबरों	आदंबरो
aadambaron	आडंबरों	आदंबरों
adambaron	आडंबरों	अदंबरों
aadat	आदत	आदत
aadatan	आदतन	आदात
aadatein	आदतें	आदतें
aadaten	आदतें	आदतें
aadaton	आदतों	आदतों
aadar	आदर	आदर
aadhipaty	आधिपत्य	आधिपत्य
aadhipatya	आधिपत्य	आधिपत्य
aadhiptay	आधिपत्य	आधिप्तय
aadhi	आधी	आधी
aadhunikata	आधुनिकता	आधुनिकता
aadhunikta	आधुनिकता	आधुनिकता
aadhunikikaran	आधुनिकीकरण	आधुनिकीकरण
aadhunikikarana	आधुनिकीकरण	आधुनिकीकरण
adhunikikaran	आधुनिकीकरण	अधुनिकीकरण
aanandita	आनंदिता	आनंदिता
aape	आपे	आपे
option	आप्शन	ओप्शन
aaf	आफ़	आफ
off	आफ़	ओफ
aabhari	आभारी	आभारी
abhari	आभारी	अभरी
aamada	आमादा	आमाड़
amaada	आमादा	अमादा
amadaa	आमादा	अमादा
aayakar	आयकर	आयकर
aaykar	आयकर	आयकर
ayekar	आयकर	अयेक
aayush	आयुष	आयुष
ayush	आयुष	अयूष
aayojik	आयोजिक	आयोजिक
aayojit	आयोजिक	आयोजित
ayojik	आयोजिक	अयोजिक
re	आरई	रे
aarch	आर्च	आर्क
arch	आर्च	आर्क
archer	आर्चर	आर्कर
aaryan	आर्यन	आर्या
aryan	आर्यन	अर्या
arya	आर्या	अर्य
aal	आल	आल
all	आल	एल
aalishaan	आलिशान	आलीशान
aalishan	आलिशान	आलीशान
aavantit	आवंटित	आवंतीत
avantit	आवंटित	अवंतीत
aavishakaron	आविष्कारों	आविषाकारों
aavishkaaron	आविष्कारों	आविष्कारों
avishkaron	आविष्कारों	अविष्कारों
aashankaon	आशंकाओं	आशंकाओं
ashankaon	आशंकाओं	आशंकाओं
aasheervachan	आशीर्वचन	आशीर्वाच
aashirvachan	आशीर्वचन	आशिर्वाच
ashirvachan	आशीर्वचन	अशीर्वाच
ashura	आशुरा	अशुरा
aashcharyajanak	आश्चर्यजनक	आश्चर्यजनक
aashcharyjank	आश्चर्यजनक	आश्चर्यजनक
ashcharyajanak	आश्चर्यजनक	अश्चर्यजनक
aashrit	आश्रित	आश्रीत
ashrit	आश्रित	अश्रीत
aasama	आसमा	आसाम
aasma	आसमा	आसमा
asma	आसमा	अस्म
aasaani	आसानी	आसानी
aasani	आसानी	आसनी
asani	आसानी	असनी
interpol	इंटरपोल	इंटरपोल
intra	इंट्रा	इंट्रा
industrial	इंडस्ट्रीयल	इंडस्ट्रियल
independant	इंडिपेंडेंट	इंडीपेंडेंट
independence	इंडिपेंडेंट	इंडेपेंडेंस
independent	इंडिपेंडेंट	इंडीपेंडेंट
independence	इंडिपेंडेंस	इंडेपेंडेंस
indy	इंडी	इंडी
indoo	इंदू	इंडू
indu	इंदू	इंडू
influenza	इंफ्लूएंजा	इन्फ्लूएंज
ekatthi	इकट्ठी	एकत्थी
ekthhi	इकट्ठी	एकथीी
ikatthi	इकट्ठी	इकत्थी
ikbal	इकबाल	इकबाल
iqbal	इकबाल	इक्बल
ekbalia	इकबालिया	एकबेलिया
ikbalia	इकबालिया	इकबालिया
ikbaliya	इकबालिया	इक्बेलिय
economy	इकॉनमी	इकॉनोम
eco	इको	इको
iko	इको	इको
economics	इकोनोमिक्स	इकॉनोमिक्स
ikhatiyar	इख्तियार	इख्तायीय
ikhtiyar	इख्तियार	इख्तियार
egypt	इजिप्ट	इज्ञप्
ijisht	इजिप्ट	इजिश्त
eat	इट	एट
it	इट	इट
its	इट्स	आईटी
ethlati	इठलाती	एथलती
ithlaati	इठलाती	इथलाती
etalvi	इतालवी	एटलवी
italavi	इतालवी	इतलवी
italvi	इतालवी	इतलवी
itihaasvid	इतिहासविद	इतिहासवीद
inlogon	इनलोगों	इनलोगों
insight	इनसाइट	इनसिघ्
insite	इनसाइट	इंसिट
insights	इनसाइट्स	इंसिघ्ट्
insites	इनसाइट्स	इंसिटेस
inset	इनसेट	इंसेट
enu	इनु	इनू
ino	इनु	इनो
inu	इनु	इनू
infantry	इन्फेंट्री	इन्फेंट्री
investigation	इन्वेस्टिगेशन	इन्वेस्टिगेशन
emerging	इमर्जिंग	एमर्जिंग
image	इमेज	इमेज
imager	इमेजर	इमेजर
eiretrea	इरीट्रिया	एयरेट्राय
eritrea	इरीट्रिया	एरिट्रीय
iritriya	इरीट्रिया	इरित्रिय
elaakon	इलाकों	इलाकों
ialkon	इलाकों	इलकों
ilakon	इलाकों	इलाकों
ilaajon	इलाजों	इलाजों
ilajon	इलाजों	इलाजों
isha	इशा	इशा
isaraar	इसरार	इसरार
isarar	इसरार	इसरार
israr	इसरार	इसरार
eesl	ईईएसएल	ईस्ल
iisl	ईईएसएल	आईएलएस
eco	ईको	इको
isabgol	ईसबगोल	इसब्गो
isbagol	ईसबगोल	इस्बैग
esvi	ईस्वी	एसवी
isvi	ईस्वी	इसवी
uksaayaa	उकसाया	उकसाया
uksaya	उकसाया	उकसाया
ukhaadana	उखाड़ना	उखाडना
ukhadna	उखाड़ना	उखाड़ना
ugaati	उगती	उगात
ugati	उगती	उगती
ugti	उगती	उगती
ugana	उगाना	उगना
ugaahi	उगाही	उगाही
ugahi	उगाही	उगाही
ucchalne	उछलने	उछलने
uchhalne	उछलने	उछलने
uchlane	उछलने	उछलान
ujadane	उजड़ने	उजाड़न
ujadne	उजड़ने	उजड़ने
uthe	उठे	उठे
odisa	उड़िसा	ओडिसा
odissa	उड़िसा	ओडिसा
udisa	उड़िसा	उड़िसा
udelte	उड़ेलते	उड़ेल्ट
udeylatey	उड़ेलते	उदेलते
utaraai	उतराई	उतराई
utrai	उतराई	उतराई
utrayi	उतराई	उतराय
utsuk	उत्सुक	उत्सूक
udairaj	उदयराज	उदयराज
udayraj	उदयराज	उदयराज
uddhghosh	उद्घोष	उद्घृष
udghosh	उद्घोष	उद्घोष
uddeshyaparak	उद्देश्यपरक	उद्देश्पारक
uddeshyparak	उद्देश्यपरक	उद्देश्परक
udham	उधम	उद्
unnees	उन्नीस	यूनीज
unnis	उन्नीस	यूनिस
upakaran	उपकरण	उपकरण
upkaran	उपकरण	उपकरण
upakaranon	उपकरणों	उपकरणों
upkaranon	उपकरणों	उपकरणों
upkhand	उपखंड	उपखंड
upadeshakon	उपदेशकों	उपदेशकों
updeshakon	उपदेशकों	उपदेशकों
upadrav	उपद्रव	उपद्रव
updrav	उपद्रव	उपद्रव
updrawa	उपद्रव	उपद्रव
upanyaaskaar	उपन्यासकार	उपन्याक्र
upnyaskar	उपन्यासकार	उपन्याक्र
upabhoktaon	उपभोक्ताओं	उपभोक्ताओं
upbhoktaon	उपभोक्ताओं	उपभोक्ताओं
upabhoktawaad	उपभोक्तावाद	उपभोक्तावाद
upbhoktavad	उपभोक्तावाद	उपभोक्तवाद
upbhoktawad	उपभोक्तावाद	उपभोक्तावाद
upabhoktawaadi	उपभोक्तावादी	उपभोक्तावादी
upbhoktavadi	उपभोक्तावादी	उपभोक्तवादी
upbhoktawadi	उपभोक्तावादी	उपभोक्तावादी
upamanyu	उपमन्यु	उपमन्यु
upmanyu	उपमन्यु	उपम्यु
upmukhyamanti	उपमुख्यमंत्री	उपमुख्यमतानी
upmukhyamantri	उपमुख्यमंत्री	उपमुख्यमंत्री
upmukhymantri	उपमुख्यमंत्री	उपमुख्यमत्ति
uplabdhata	उपलब्धता	उपलब्धता
uplabhdhata	उपलब्धता	उपलभद्धत
uplabdhi	उपलब्धि	उपलब्धी
uplabdhiyaan	उपलब्धियां	उपलब्धियां
uplabdhiyan	उपलब्धियां	उपलब्धियां
uplabhiyan	उपलब्धियां	उपलभीयन
uplabdh	उपलव्ध	उपलब्ध
upved	उपवेद	उपवेद
upasthit	उपस्थित	उपस्थित
upsthit	उपस्थित	उपस्थित
uppal	उप्पल	उपपल
ubhar	उभार	उभर
ubhaaron	उभारों	उभारों
ubharon	उभारों	उभरों
umas	उमस	उम्
urvarak	उर्वरक	उर्वार
urwarak	उर्वरक	उर्वाक
urvarakta	उर्वरकता	उर्वारक्
urvarkata	उर्वरकता	उर्वर्कत
urwarkata	उर्वरकता	उर्वाक्त
arwara	उर्वरा	अरवारा
urvara	उर्वरा	उर्वरा
uljhane	उलझाने	उलझने
ulat	उलट	उला
ulati	उलटी	उलात
ulti	उलटी	उल्त
ulti	उल्टी	उल्ती
ulte	उल्टे	उलते
ullekh	उल्लेख	उल्लेख
ullekhit	उल्लेखित	उल्लेखित
urf	ऊर्फ	यूरी
urfa	ऊर्फ	उर्फ
ra	ऋ	र
ru	ऋ	र
rituraj	ऋतुराज	रितुरा
ruturaj	ऋतुराज	रुतुरज
rishi	ऋर्षि	रिशी
rushi	ऋर्षि	रूशी
rishabh	ऋषभ	रिश
rushabh	ऋषभ	रुश
enzymes	एंजाइम्स	एंजमेस
antena	एंटेना	अंतेना
antenna	एंटेना	अंतेन्
antonia	एंटोनिया	एंटोनिया
antoniya	एंटोनिया	अंतोनिया
anderson	एंडरसन	एंडर्स
arc	एआरसी	आर्क
aml	एएमएल	अम्ल
amg	एएमजी	एमगी
ekarman	एकरमैन	एकर्मन
ekarmen	एकरमैन	एकर्मे
yakarman	एकरमैन	यकर्मण
ekatmakta	एकात्मकता	एकत्मकता
ekatmkata	एकात्मकता	एकत्मकता
exit	एक्ज़िट	एक्सिट
executive	एक्जीक्यूटिव	एक्सेक्टिव
exhicutive	एक्जीक्यूटिव	एक्शीक्युटिव
excel	एक्सल	एक्से
hec	एचईसी	हेक
hic	एचईसी	हीक
atrasiya	एट्रेसिया	अत्रसिया
atresiya	एट्रेसिया	अत्रेसिया
etresiya	एट्रेसिया	एटरेसिया
ad	एड	एड
add	एड	एड
ed	एड	ईड
adan	एडन	अदा
aiden	एडन	ऐडे
adidas	एडिडास	अदिदास
adolf	एडॉल्फ	ऐडोल्फ
adolf	एडोल्फ	ऐडोल्फ
ethan	एथन	इथा
nhs	एनएचएस	एनएसएस
nmdc	एनएमडीसी	एमएसडीी
nsa	एनएसए	एनएसए
ngo	एनजीओ	नगो
npf	एनपीएफ	एनपीएफ
mx	एमएक्स	एमएसएम
mhrd	एमएचआरडी	महर्द
msn	एमएसएन	एमएनएस
mts	एमटीएस	एमएस
mdma	एमडीएमए	मदमा
mbd	एमबीडी	एमबीडी
emilie	एमिली	एमिली
emily	एमिली	इमिली
elvis	एलविस	एलविस
allied	एलाइड	एलियड
elaid	एलाइड	एलायड
alex	एलेक्स	एलेक्स
elex	एलेक्स	इलेक्स
alexis	एलेक्सिस	एलेक्सिस
alexix	एलेक्सिस	एलेक्सिक
elexis	एलेक्सिस	एलेक्सिस
alexi	एलेक्सी	एलेक्सी
alexy	एलेक्सी	एलेक्सी
alder	एल्डर	अल्डर
elder	एल्डर	एल्डर
alphabet	एल्फाबेट	अल्फाबेट
alvin	एल्विन	अलविन
elvin	एल्विन	इलविन
avlin	एवलिन	अवलीन
evelyn	एवलिन	इवेलि
evo	एवो	एवो
ashton	एश्टन	आष्टो
sa	एसए	स
sf	एसएफ	एफएफ
sm	एसएम	एमएम
sg	एसजी	एसजी
ncg	एससीजी	एनसीएन
scg	एससीजी	एससीएफ
acetate	एसिटेट	एसेटेट
acidate	एसिटेट	असीदेट
acf	एसीएफ	एसीएफ
associationon	एसोसिएशनों	असोसिएशनों
asther	एस्थर	अस्थे
esther	एस्थर	एस्थर
aesthetics	एस्थेटिक्स	एस्थेटिक्स
asthetics	एस्थेटिक्स	एस्थेटिक्स
aisi	एैसी	ऐसी
actors	ऐक्टर्स	एक्टर्स
activation	ऐक्टिवेशन	अक्टिवेशन
age	ऐज	एज
edge	ऐज	एज
aillen	ऐलन	एले
ellan	ऐलन	इला
aili	ऐली	एली
ailly	ऐली	एली
eli	ऐली	एली
elli	ऐली	एली
auckland	ऑकलैंड	ऑकलैंड
oakland	ऑकलैंड	ओकलंद
audio	ऑडियो	ऑडियो
object	ऑब्जेक्ट	ओब्जेक्ट
objects	ऑब्जेक्ट्स	ऑब्केट्स
oscar	ऑस्कर	ऑस्का
oscars	ऑस्कर्स	ऑस्कार्
onth	ओंठ	ओंथ
oasis	ओएसिस	ऑसिस
auchhi	ओछी	औची
ochhi	ओछी	ओछी
ojon	ओजोन	ओजों
ozone	ओजोन	ओजोन
ojhal	ओझल	ओझल
ozal	ओझल	ओजल
auto	ओटो	औटो
ono	ओनो	ओनो
opal	ओपल	ओपल
orlando	ओरलैंडो	ओर्लैंड
original	ओरिजिनल	ओरिजिनल
overseas	ओवरसीज	ऑवर्से
os	ओस	ओए
ohayo	ओहायो	ओहायो
ohio	ओहायो	ओहियो
aushadhalay	औषधालय	औषधालय
aushdhalay	औषधालय	औषधालय
aur	औेर	और
kankadon	कंकड़ों	कंकड़ों
kankaron	कंकड़ों	कंकरों
kanchon	कंचों	कांचो
congestion	कंजेशन	कंजेस्
conjesion	कंजेशन	कंजेशन
conjunction	कंजेशन	कंजनक्
consumer	कंज्यूमर	कंसमर
controlled	कंट्रोल्ड	कंट्रोल्ड
kandmool	कंदमूल	कंदमूल
kandmul	कंदमूल	कंदमुल
kanmul	कंदमूल	कन्मूल
kampkampi	कंपकपी	कांपका
kampkapi	कंपकपी	कांपका
kambal	कंबल	कांब
kanbal	कंबल	कांब
kakshak	कक्षक	कक्षक
kakshaen	कक्षाएं	कक्षाएं
kakshayen	कक्षाएं	कक्षाएं
kashaen	कक्षाएं	कशाएं
kachaura	कचौरी	कचौरा
kachauri	कचौरी	कचौरी
kachuri	कचौरी	कचुरी
katvana	कटवाना	कटवाना
katwana	कटवाना	कटवाना
katahal	कटहल	कटहल
kathal	कटहल	कथल
katas	कटास	कटस
kadakadaduuma	कड़कड़डूमा	कड़कदुमाम
kadakadduma	कड़कड़डूमा	कड़कद्मुा
kadkadduma	कड़कड़डूमा	कड़कद्मुा
katai	कतई	कता
kataii	कतई	कता
katla	कतला	कटला
katlaa	कतला	कटला
kadamtaal	कदमताल	कदमतल
kadamtal	कदमताल	कदमतल
connect	कनेक्ट	कनेक्ट
connector	कनेक्टर	कनेक्टर
connecting	कनेक्टिंग	कनेक्टिंग
connectivity	कनेक्टिविटी	कनेक्टिविटी
kapol	कपोल	कपोल
kpol	कपोल	कपोल
coupolon	कपोलों	कुपोलो
kapolon	कपोलों	कपोलों
kab	कब	कब
kamaccha	कमच्छा	कमच्छा
kamccha	कमच्छा	कामचा
kamchcha	कमच्छा	काच्चा
kamjoriyan	कमज़ोरियां	कमजोरियन
kamzoriyan	कमज़ोरियां	कमजोरियन
kamjoriyon	कमज़ोरियों	कमजोरियों
kamzoriyon	कमज़ोरियों	कमजोरियों
kamjori	कमज़ोरी	कमजोरी
kamzori	कमज़ोरी	कमजोरी
kamataul	कमतौल	कमातु
kamtaul	कमतौल	कमतौल
kamariya	कमरिया	कामरीय
kmariya	कमरिया	कमारिय
kamalini	कमलिनी	कमलीनी
kamlini	कमलिनी	कामलिन
committee	कमिटी	कमिटी
commity	कमिटी	कमिटी
kaami	कमी	काम
kami	कमी	काम
karkamlon	करकमलों	कर्मकलो
karkmalon	करकमलों	कर्मकाल
kara	करा	करा
kareem	करीम	करीम
karim	करीम	करीम
karae	करै	करा
karai	करै	करा
karolbagh	करोलबाग	करोल्भा
karolbaugh	करोलबाग	करोलबाग
curt	कर्ट	कर्ट
kurt	कर्ट	कुर्
karnafool	कर्णफूल	कार्नफू
karnaphool	कर्णफूल	कार्नफू
karnful	कर्णफूल	कार्नफु
karta	कर्ता	करता
karnatak	कर्नाटक	कारणातक
karnataka	कर्नाटक	कारणातक
curv	कर्व	कर्व
curve	कर्व	कर्व
kalkal	कलकल	कलकल
kalyug	कलयुग	कल्यु
kalpana	कल्पना	कल्पना
kalpna	कल्पना	कल्पना
kavval	कव्वाल	कव्वल
qawwal	कव्वाल	कव्वल
kashish	कशिश	कशीष
kasht	कष्ट	कष्ट
kasamen	कसमें	कसमें
kasmen	कसमें	कसमें
kahlaegi	कहलाएगी	कहलाएगी
kahlayegi	कहलाएगी	कहलाएगी
kahein	कहें	कहें
kahen	कहें	कहें
kazi	क़ाज़ी	काजी
qazi	क़ाज़ी	काजी
kanta	कांटा	कांता
kanti	कांटी	कांती
kante	कांटे	कांते
kanto	कांटो	कांटो
kanton	कांटों	कांटों
kandal	कांडला	कंदल
kandala	कांडला	कंदला
kandla	कांडला	कंदला
counter	काउंटर	काउंटर
cauntron	काउंटरों	कैंट्रों
counteron	काउंटरों	कंटरों
kaag	काग	काग
kag	काग	काग
kaagaji	कागज़ी	कागजी
kaagazi	कागज़ी	कागजी
kaagji	कागज़ी	कागजी
kaagzi	कागज़ी	कागजी
kagaji	कागज़ी	कागजी
kagazi	कागज़ी	कागजी
kagji	कागज़ी	कागजी
kagzi	कागज़ी	कागजी
kaagajo	कागज़ों	कागजो
kaagajon	कागज़ों	कागजों
kaagazon	कागज़ों	कागजों
kagajon	कागज़ों	कागजों
kagazon	कागज़ों	कागजों
katjoo	काट्जू	कटजू
katju	काट्जू	कटजू
katyayani	कात्यायनी	कत्यायनी
katyayni	कात्यायनी	कत्याएंी
kadiyan	कादियान	कड़ियां
kadiyana	कादियान	कडियाना
kaabiliyat	काबिलियत	काबिलियत
kabiliyat	काबिलियत	कबिलियत
karkhanon	कारखानों	करखानों
cardinalon	कार्डिनलों	कार्डिनलों
kardinalon	कार्डिनलों	कर्दिनलों
kartiki	कार्तिकी	कार्टिकी
karyakarta	कार्यकर्ता	कर्यकर्ता
karykarta	कार्यकर्ता	कर्यकर्ता
kaalaka	कालका	कालका
kalka	कालका	कालका
kala	काला	कला
kalis	कालिस	कालिस
coloniyan	कालोनियां	कलोनियन
kaloniyan	कालोनियां	कलोनियन
coloniyon	कालोनियों	कलोनियों
colonyon	कालोनियों	कलोनियों
kaloniyon	कालोनियों	कलोनियों
kitani	कितनी	कितान
kitni	कितनी	कितनी
kiran	किरण	किरा
kiranon	किरणों	किरानो
kirnon	किरणों	किरनों
kiraya	किराया	किराया
kileband	किलेबंद	किलेबंद
kisaan	किसान	किसान
kisan	किसान	किसन
kicker	कीकर	किकर
kikar	कीकर	किकर
kunthit	कुंठित	कुंठित
kundali	कुंडली	कुंडली
kundli	कुंडली	कुंडली
cucunur	कुकुनूर	कुक्यूर
kukunoor	कुकुनूर	कुकुणूर
kukunur	कुकुनूर	कुकुणुर
kutumbakkam	कुटुंबकम्	कुतुमबक्त
kutumbkam	कुटुंबकम्	कुतुमबक्म
kutunmbakam	कुटुंबकम्	कुतुंबकम
kuprabandhan	कुप्रबंधन	कुपराबंधन
kumhar	कुम्हार	कुम्हार
kurkura	कुरकुरा	कुरकुरा
kuru	कुरू	कुरू
kursiyan	कुर्सियां	कुरसियां
kursi	कुर्सी	कुर्सी
kulle	कुल्ले	कुले
cution	कुशन	कटिय
kushan	कुशन	कुशा
kusanskar	कुसंस्कार	कुसंस्कर
kusanskaron	कुसंस्कारों	कुसंस्करों
kootaa	कूटा	कूटा
kuta	कूटा	कुटा
kutaa	कूटा	कुटा
kritatva	कृतित्व	कृतत्व
krititv	कृतित्व	कृतित्व
krititva	कृतित्व	कृतित्व
kritiyon	कृतियों	कृतियों
krishi	कृषि	कृषी
krishanam	कृष्णम	कृष्णम
krishnam	कृष्णम	कृष्णम
cake	केक	केक
cader	केडर	केडर
cadre	केडर	केडर
cameo	केमियो	कैमो
kemiyo	केमियो	केमियो
kelaang	केलांग	केलांग
kelang	केलांग	केलंग
case	केस	केस
kes	केस	केस
cason	केसों	कैसन
keson	केसों	केसों
canbara	कैनबरा	कैंबरा
canberra	कैनबरा	कैंबरर
canedi	कैनेडी	कैनेडी
kennedy	कैनेडी	केनेडी
camilo	कैमिलो	कैमिलो
kamilo	कैमिलो	कमिलो
character	कैरेक्टर	चारेटर
characters	कैरेक्टर्स	चारेक्टर्स
carolin	कैरोलिन	कारोलिन
caroline	कैरोलिन	कारोलिन
carolyn	कैरोलिन	कारोलिन
calorie	कैलोरी	कैलोरी
cashback	कैशबैक	कैशबैक
coin	कॉइन	कोइन
cong	कॉन्ग	कांग
kong	कॉन्ग	कोंग
condom	कॉन्डोम	कंडोम
combo	कोंबो	कॉम्ब
koilavar	कोइलवर	कोइलाव
koilover	कोइलवर	कोइलोव
koilwar	कोइलवर	कोइलवा
kokrajhaar	कोकराझार	कोकराझार
kokrajhar	कोकराझार	कोकराझार
kokrazar	कोकराझार	कोकराजार
coachon	कोचों	कोचों
cochon	कोचों	कचों
kochon	कोचों	कोचों
kotali	कोटली	कोटली
coded	कोडेड	कॉड
coma	कोमा	कोमा
coram	कोरम	कोरम
koram	कोरम	कोरम
coal	कोल	कोल
cholesterol	कोलेस्ट्रोल	चलेस्टरोल
collam	कोल्लम	कॉलम
kollam	कोल्लम	कोलम
kollum	कोल्लम	कोलम
koshikiy	कोशिकीय	कोशिकीय
koshikiya	कोशिकीय	कोशिकीय
koshkiy	कोशिकीय	कोशकीय
coastar	कोस्टार	कोस्टर
costar	कोस्टार	कॉस्टर
kautik	कौतिक	कौतिक
kaushik	कौशिक	कौशिक
cuba	क्यूबा	कुबा
cubic	क्यूबिक	कबीस
kyuubik	क्यूबिक	क्युबिक
kranti	क्रांति	क्रांती
creative	क्रिएटिव	क्रीएटिव
cricketaron	क्रिकेटरों	क्रिकेटरों
cricketeron	क्रिकेटरों	क्रिकेटरों
crete	क्रीट	क्रीट
krit	क्रीट	कृत
crook	क्रुक	क्रूक
cruck	क्रुक	क्रक
cruise	क्रूज़	क्रूज
cruz	क्रूज़	क्रूज
cruiser	क्रूज़र	क्रूजर
cruzer	क्रूज़र	क्रूजर
kruratam	क्रूरतम	कृरतम
krurtam	क्रूरतम	कृरतम
kurtam	क्रूरतम	कुर्तम
cruise	क्रूस	क्रूज
cyrus	क्रूस	सायरस
krus	क्रूस	क्रूस
crazy	क्रेज़ी	क्रेजी
crest	क्रेस्ट	क्रेस्ट
krest	क्रेस्ट	क्रेस्ट
crops	क्रॉप्स	क्रॉप्स
croaker	क्रोकर	क्रॉकर
crocker	क्रोकर	क्रॉकर
krokar	क्रोकर	क्रोकर
croma	क्रोमा	क्रोमा
chromium	क्रोमियम	क्रोमियम
chromate	क्रोमेट	च्रोमेट
climate	क्रोमेट	क्लाइमे
climate	क्लाइमेट	क्लाइमेट
class	क्लास	क्लास
classical	क्लासिकल	क्लासिकल
classi	क्लासी	क्लासी
classy	क्लासी	क्लास्
classification	क्लासीफिकेशन	क्लासिफिकेशन
clasen	क्लासेन	क्लेसन
cleanser	क्लिंजर	क्लींसर
cleg	क्लेग	क्लेग
kleg	क्लेग	क्लेग
clan	क्लेन	क्लैन
clane	क्लेन	क्लेन
clen	क्लेन	क्लेन
cler	क्लेर	क्लर
cvanr	क्वांर	क्वेर
quanr	क्वांर	क्वार्
qwanr	क्वांर	क्वांर
kshamadan	क्षमादान	क्षमदान
kshmadan	क्षमादान	क्षमदान
shmadan	क्षमादान	शमादन
kshmasheel	क्षमाशील	क्षमशील
kshmashil	क्षमाशील	क्षमशिल
shmashil	क्षमाशील	शमशील
kshinta	क्षीणता	क्षिणता
shinta	क्षीणता	शीनताा
kshem	क्षेम	क्षेम
shem	क्षेम	शेम
khand	खंड	खंड
khandwa	खंडवा	खंडवा
khatak	खटक	खात
khtak	खटक	खतक
khatta	खट्टा	खात्त
khadagpur	खड़गपुर	खदागपुर
kharagpur	खड़गपुर	खरगपुर
khada	खड़ा	खड़ा
khand	खण्ड	खंड
khanda	खण्ड	खंडा
khata	खता	खात
khaton	खतों	खातो
khanijon	खनिकों	खनीजों
khanikon	खनिकों	खानीको
khabboo	खब्बू	खब्बू
khabbu	खब्बू	खब्बू
khaman	खमण	खमन
khamman	खमण	खम्
khamariya	खमरिया	खामरीय
khamriya	खमरिया	खामरीय
kharsiya	खरसिया	खर्सिय
kharaash	खराश	खराश
kharash	खराश	खराश
kharcheeli	खर्चीली	खर्चीली
kharchilee	खर्चीली	खर्चिली
kharchili	खर्चीली	खर्चिली
khalnayakon	खलनायकों	खलनायकों
khajana	ख़ज़ाना	खजनाा
khawaja	ख़्वाजा	खवाजाा
khwaja	ख़्वाजा	ख्वाजा
khaanche	खांचे	खांचे
khanche	खांचे	खांचे
khaatamey	खात्मे	खातमे
khatme	खात्मे	खत्मे
khala	खाला	खला
khalon	खालों	खलों
khaaskar	खासकर	खासकर
khaskar	खासकर	खासकर
khilkar	खिलकर	खिलकर
khilauna	खिलौना	खिलौना
khilona	खिलौना	खिलोना
khisakkar	खिसककर	खिसकका
khudava	खुदवा	खुड़व
khudwa	खुदवा	खुड़व
khurd	खुर्द	खुरद
khurda	खुर्दा	खुरदा
khush	खुश	खुश
khushiyon	खुशियों	खुशियों
khusaro	खुसरो	खुसरो
khusro	खुसरो	खुसरो
kheda	खेड़ा	खेड़ा
khemkaran	खेमकरण	खेमकरण
khaira	खैरा	खैरा
khor	खोर	खोर
khola	खोला	खोला
gangabaai	गंगाबाई	गंगबाई
gangabai	गंगाबाई	गंगबाई
ganjepan	गंजेपन	गंजेपन
gandak	गंडक	गंदक
gau	गऊ	गौ
gatta	गट्टा	गत्ता
gadkari	गडकरी	गड़कर
gadhiya	गढ़िया	गढ़िया
gadhiyan	गढ़िया	गढ़िया
ganataantrik	गणतांत्रिक	गणतांत्रिक
ganatantrik	गणतांत्रिक	गणतंत्रिक
gantantrik	गणतांत्रिक	गंतांत्रिक
ganaraajya	गणराज्य	गणराज्य
ganarajya	गणराज्य	गणराज्य
ganrajya	गणराज्य	गणराज्य
ganarajyon	गणराज्यों	गणराज्यों
ganrajyon	गणराज्यों	गणराज्यों
gunboat	गनबोट	गुणबो
gunbot	गनबोट	गुणबो
gar	गर	गर
garib	गरीब	गरीब
garibon	गरीबों	गरीबों
garjan	गर्जन	गर्जन
garbhagrih	गर्भगृह	गर्भागृ
garbhgrah	गर्भगृह	गर्भग्र
garbhgrih	गर्भगृह	गर्भगृह
garbhini	गर्भिणी	गर्भीनी
garmahat	गर्माहट	गर्महात
girls	गर्ल्स	गिर्ल्
galatfahmiyon	गलतफहमियों	गलातफाह्मि
galatfehmiyon	गलतफहमियों	गलातफहियों
galatfahmi	गलतफहमी	गलतफाहम
galatfehmi	गलतफहमी	गलतफेमी
galegi	गलेगी	गलेगी
gavan	गवां	गवन
guided	गाइडेड	गिडेड
gaba	गाबा	गाबा
gartner	गार्टनर	गर्टनर
gardener	गार्डनर	गैर्डनर
gardner	गार्डनर	गैर्डर
garnet	गार्नेट	गर्नेत
galav	गालव	गलव
galv	गालव	गलव
gidgidane	गिड़गिड़ाने	गिडगिडने
giriraj	गिरीराज	गिरीरज
gire	गिरे	गिरे
gilas	गिलास	गिलास
geeta	गीता	गीता
gita	गीता	गिता
gile	गीले	गिले
gunj	गुंज	गुंज
gujara	गुजरा	गुजरा
gujra	गुजरा	गुजरा
gujari	गुजारी	गुजरी
gundosh	गुणदोष	गुंडोश
gungunate	गुनगुनाते	गुंगुनते
gungunathe	गुनगुनाते	गुनगुनाथे
guptkal	गुप्तकाल	गुप्तकाल
gupta	गुप्ता	गुप्ता
gufatgu	गुफ्तगू	गुफातगु
guftgoo	गुफ्तगू	गुफ्तो
guftgu	गुफ्तगू	गुफ्तु
gurcharan	गुरचरण	गुरचरण
gurujan	गुरुजन	गुरूजन
gurda	गुर्दा	गुरदा
gulli	गुल्ली	गुल्ली
gujari	गूजरी	गुजरी
gena	गेना	गेना
gayl	गेल	गेल
gayle	गेल	गाय
gel	गेल	जेल
gas	गेस	गैस
guess	गेस	ग्य
going	गोइंग	गोइंग
goethe	गोएथे	गोते
goyethe	गोएथे	गोयथे
gogunda	गोगुंदा	गोगंडा
gomatinagar	गोमतीनगर	गोमतिनाग
gomtinagar	गोमतीनगर	गोमतिनाग
gombe	गोम्बे	गोमे
gor	गोर	गोर
goron	गोरों	गोरों
goroun	गोरों	गोरौन
goshthi	गोष्ठी	गोष्ठी
gauhar	गौहर	गौहा
gyaarah	ग्यारह	ज्ञारह
gyarah	ग्यारह	ज्ञारह
granth	ग्रंथ	ग्रां
grantho	ग्रंथो	ग्रांथ
granthon	ग्रंथों	ग्रांथो
graft	ग्राफ्ट	ग्राफ्ट
grapht	ग्राफ्ट	ग्राफ़
gramin	ग्रामीण	ग्रामिन
graminon	ग्रामीणों	ग्रामिनों
gramoday	ग्रामोदय	ग्रामोडे
grim	ग्रिम	ग्रीम
grain	ग्रैन	ग्रेन
gran	ग्रैन	ग्राण
glacier	ग्लेशियर	ग्लैसियर
glacieron	ग्लेशियरों	ग्लासियरों
glecieron	ग्लेशियरों	ग्लेसियरों
ghanghor	घनघोर	घंघोर
ghamasan	घमासान	घमसन
gharwaale	घरवाले	घरवाले
gharwale	घरवाले	घरवाले
gharat	घराट	घरात
ghati	घाटी	घटी
ghis	घिस	घीस
ghisen	घिसें	घिसेन
ghutno	घुटनो	घुटनो
ghud	घुड़	घुड़
ghumakkad	घुमक्कड़	घुमाक्कड
ghumaati	घुमाती	घुमाती
ghumati	घुमाती	घुमती
ghuspaith	घुसपैठ	घुस्पै
ghuspet	घुसपैठ	घुसपेट
ghuspaithiyan	घुसपैठियों	चुस्पैथिया
ghuspaithiyon	घुसपैठियों	घुस्पैथियो
ghuspetiyoun	घुसपैठियों	घुस्पेटियो
ghoonse	घूंसे	घूंसे
ghunse	घूंसे	घुंसे
ghoomti	घूमती	घूमती
ghumati	घूमती	घुमती
ghumthi	घूमती	घुम्थ
ghumti	घूमती	घुमती
ghoomte	घूमते	घूमते
ghumate	घूमते	घुमात
ghumte	घूमते	घुमते
ghumthe	घूमते	घूमते
ghoomaane	घूमाने	घूमने
ghumaane	घूमाने	घुमाने
ghumane	घूमाने	घुमाने
gherna	घेरना	घेरना
ghernaa	घेरना	घेरना
gholate	घोलते	घोलते
gholte	घोलते	घोलते
ch	च	च
cha	च	च
chandar	चंदर	चंदर
chander	चंदर	चंदे
chandra	चंदर	चंद्
chanda	चंदा	चंदा
chandaa	चंदा	चंदा
chande	चंदे	चंदे
chandrama	चंद्रमा	चंद्रमा
chandrma	चंद्रमा	चंद्रमा
chakaleshwar	चकलेश्वर	चकलेश्वर
chakleshwar	चकलेश्वर	चकलेश्वर
chakkaron	चक्करों	चक्करों
chacheri	चचेरी	चचेरी
chatargy	चटर्जी	चैटर्ज
chatarji	चटर्जी	चतरजी
chatterjee	चटर्जी	चट्रजी
chatushkon	चतुष्कोण	चटुशकों
chapate	चपेट	चपटे
chapet	चपेट	चैपट
chamoli	चमोली	चमोली
charachar	चराचर	चराचा
chalaaki	चलाकी	चलाकी
chalaki	चलाकी	चलाकी
chahchahahat	चहचहाहट	चहचहाहट
chahate	चहते	चाहत
chahte	चहते	चाहत
chahara	चहरा	चाहर
chehra	चहरा	चेहर
childhood	चाइल्डहुड	चिल्डौड़
chak	चाक	चक
chatate	चाटते	चटते
chatane	चाटने	चटने
chatne	चाटने	चटने
chatumars	चातुर्मास	चैटमर्स
chaturmas	चातुर्मास	चटुरमास
chadrein	चादरें	चड्रें
chadren	चादरें	चड़ेरे
chardiwari	चारदिवारी	चर्दीवारी
charu	चारु	चारू
chare	चारे	चेयर
charo	चारो	चारो
charger	चार्जर	चार्जर
charter	चार्टर	चार्टर
chahega	चाहेगा	चाहेगा
chintu	चिंटू	चिंतु
chintajanak	चिंताजनक	चिंताजनक
chintajank	चिंताजनक	चिंताजनक
chithhiyon	चिठ्ठियों	चिथियों
chiththiyon	चिठ्ठियों	चित्तियों
chitthiyon	चिठ्ठियों	चित्तियों
chidchide	चिड़चिड़े	चिड़चिड़
chiththa	चित्त	चित्थ
chitt	चित्त	चिट्ट
chiththi	चित्ती	चीठती
chitti	चित्ती	चित्ती
chithrkari	चित्रकारी	चित्रकारी
chitrkari	चित्रकारी	चित्रकारी
chithrkaron	चित्रकारों	चित्रकरों
chitrakaron	चित्रकारों	चित्राकारो
chitrkaron	चित्रकारों	चित्रकरों
chita	चीता	चिता
chithade	चीथड़े	चितड़े
chumban	चुंबन	चुंबन
chunban	चुंबन	चुनबन
chukata	चुकाता	चुकता
chukatha	चुकाता	चुकठा
chunani	चुननी	चुनान
chunnani	चुननी	चुननी
chunni	चुननी	चुन्न
chunavaa	चुनवा	चुनाव
chunva	चुनवा	चुनवा
chunwa	चुनवा	चुनवा
chunauti	चुनौति	चुनौती
chunothi	चुनौति	चुनौती
chunautiyon	चुनौतियों	चुनौतियों
chunothiyon	चुनौतियों	चुनौतियों
chubh	चुभ	चुभ
chase	चेज	चास
chej	चेज	चेज
chatak	चेटक	चटक
chetak	चेटक	चेतक
chettiar	चेट्टियार	चेत्तायर
chettiyar	चेट्टियार	चेत्तीयर
chelsea	चेल्सी	चेल्सि
chelsy	चेल्सी	चेल्सी
choriyaan	चोरियां	चोरियां
choriyan	चोरियां	चोरियां
choriyo	चोरियों	चोरियो
choriyon	चोरियों	चोरियों
chankati	चौंकती	चंकटी
chaunkati	चौंकती	चौंकटी
chaunkti	चौंकती	चौंकती
chauntis	चौंतीस	चौंटीस
chaunsath	चौंसठ	चौंसा
chausath	चौंसठ	चौस्थ
chaukiyon	चौकियों	चौकियों
chaukon	चौकों	चौकों
chaupalo	चौपालों	चौपालो
chaupalon	चौपालों	चौपालों
chaube	चौबे	चौबे
chaubepur	चौबेपुर	चौबेपुर
chhapra	छपरा	छाप्
chhapan	छप्पन	छापन
chhappan	छप्पन	छप्पन
chhalaavaa	छलावा	छलावा
chhalava	छलावा	छलवा
chhaviyaan	छवियां	छाविया
chhaviyan	छवियां	छाविया
chhaviyon	छवियों	छावियो
chhae	छाए	छाई
chhaye	छाए	छाय
chhach	छाछ	छाच
chhachh	छाछ	छाछ
chhaanakar	छानकर	छानकर
chhankar	छानकर	छांकर
chaya	छाया	चाया
chhaya	छाया	छाया
chhaayaakaar	छायाकार	छायाकार
chhayakar	छायाकार	छायाकार
chayaprati	छायाप्रति	चयप्रति
chhaayaaprati	छायाप्रति	छायाप्रति
chhayaprati	छायाप्रति	छायप्रति
chhit	छिट	छित
chhid	छिड़	छीड़
chhida	छिड़ा	छिड़ा
chhidaa	छिड़ा	छिड़ा
chhidi	छिड़ी	छीड़ी
chheepate	छिपते	छीपते
chhipate	छिपते	छिपटे
chhipte	छिपते	छिपटे
chhup	छुप	छुप
chhupi	छुपी	छुपी
chhupy	छुपी	छुपी
chupi	छुपी	चुपी
chhpe	छुपे	छपे
chhupe	छुपे	छुपे
chhooti	छूती	छूटी
chhuti	छूती	छुटी
chhedate	छेड़ते	छेड़ते
chhedte	छेड़ते	छेड़ते
chhodane	छोड़ने	छोड़ने
chhodne	छोड़ने	छोड़ने
janjeer	जंजीर	जनजीर
zanjeer	जंजीर	जनजीर
janjeera	जंजीरा	जनजीरा
janjira	जंजीरा	जनजीर
jnjiraa	जंजीरा	जनजीरा
janjeere	जंजीरें	जनजीरे
janjeeren	जंजीरें	जनजीरें
janjiren	जंजीरें	जनजीरें
zanjiren	जंजीरें	जनजीर्ण
zanzeeren	जंजीरें	ज़ज़ीरे
janjeeron	जंजीरों	जनजीरों
janjiroa	जंजीरों	जांजीरो
janjiron	जंजीरों	जांजीरो
janziron	जंजीरों	जांजीरो
zanjeeron	जंजीरों	जनजीरों
jakad	जकड़	जाकड
jakd	जकड़	जाद्
jagadishpur	जगदीशपुर	जगदीशपुर
jagdeeshpur	जगदीशपुर	जगदीशपुर
jagdishpur	जगदीशपुर	जगदीशपुर
jajh	जज	जा
judge	जज	जु
jujge	जज	जु
jatavaadaa	जटवाड़ा	जतावादा
jatbaada	जटवाड़ा	जतबाड़ा
jatvada	जटवाड़ा	जटवाड़ा
jatwada	जटवाड़ा	जटवाड़ा
jatelta	जटिलता	जटेलता
jatilataa	जटिलता	जटिलता
jatilta	जटिलता	जटिलता
jatiltaa	जटिलता	जटिलता
jtilta	जटिलता	जटिलता
jtiltaa	जटिलता	जटिलता
jateltaon	जटिलताओं	जटेलताओं
jatilataon	जटिलताओं	जटिलाताओ
jatiltaon	जटिलताओं	जटिलताओं
jtiltaaon	जटिलताओं	जतिलताओं
jtiltaon	जटिलताओं	जटिलताओं
jadata	जड़ता	जड़ता
jadataa	जड़ता	जड़ता
jadta	जड़ता	जड़ता
jaddi	जड़ी	जड़ी
jadee	जड़ी	जड़ी
jadi	जड़ी	जादी
jdi	जड़ी	जडी
jado	जड़ों	जड़ो
jadon	जड़ों	जड़ों
jataane	जताने	जटाने
jatane	जताने	जटने
jtane	जताने	जटने
janagana	जनगण	जनगन
jangan	जनगण	जांग
janajeevan	जनजीवन	जनजीवन
janajivan	जनजीवन	जनजीवन
janjeevan	जनजीवन	जनजीवन
janjevan	जनजीवन	जनजेवन
janjivan	जनजीवन	जनजीवन
janjivn	जनजीवन	जनजीवन
jananeta	जननेता	जननेता
janantaa	जननेता	जनताा
janneta	जननेता	जननेता
jannetaa	जननेता	जननेता
janasangh	जनसंघ	जनसंघ
jansangh	जनसंघ	जनसंह
jansngh	जनसंघ	जनसंह
janasoochana	जनसूचना	जनसूचना
janasuchana	जनसूचना	जनसुचना
janasuchna	जनसूचना	जनसूचना
jansuchana	जनसूचना	जनसूचना
jansuchna	जनसूचना	जनसूचना
jansuchnaa	जनसूचना	जनसुचना
janaab	जनाब	जनब
janab	जनाब	जनब
janaopayogi	जनोपयोगी	जनोपयोगी
janopayogee	जनोपयोगी	जनोपयोगी
janopayogi	जनोपयोगी	जनोपयोगी
jannat	जन्नत	जन्नत
janmashati	जन्मशती	जन्मशात
janmshati	जन्मशती	जन्मशात
jamashedpur	जमशेदपुर	जमशेदपुर
jamshedpur	जमशेदपुर	जमशेदपुर
jayate	जयते	जायत
jayte	जयते	जायत
jaideep	जयदीप	जैदीप
jayadeep	जयदीप	जयदीप
jayadip	जयदीप	जायदी
jaydeep	जयदीप	जयदीप
jayan	जयन	जाय
jayen	जयन	जाए
jaishankar	जयशंकर	जैशंकर
jayshankar	जयशंकर	जयशंकर
jaisawal	जयसवाल	जैसवाल
jaiswal	जयसवाल	जैसवाल
jaya	जया	जाय
jayaa	जया	जाय
jalaajali	जलांजलि	जलाजली
jalaanjali	जलांजलि	जलांजलि
jalanjali	जलांजलि	जलंजलि
javeri	जवेरी	जवेरी
zaveri	जवेरी	जवेरी
jahar	जहर	जाह
jaher	जहर	जाह
zahar	जहर	जाह
zaher	जहर	ज़ह
jaharon	जहरों	जहरों
jahron	जहरों	जहरों
zameer	ज़मीर	जमीर
zamir	ज़मीर	जमीर
jaao	जाओ	जाओ
jao	जाओ	जाओ
jaagkar	जागकर	जागकर
jagakar	जागकर	जगकर
jagkar	जागकर	जगकर
jaagati	जागती	जागती
jagati	जागती	जगती
jaagane	जागने	जागने
jagane	जागने	जगने
jagne	जागने	जगने
jagrat	जागृत	जगरत
jagrit	जागृत	जगरित
jagrut	जागृत	जगरूत
jaago	जागो	जागो
jago	जागो	जगो
jaajpur	जाजपुर	जाजपुर
jajapur	जाजपुर	जजापुर
jajpur	जाजपुर	जजपुर
jaade	जाड़े	जादे
jade	जाड़े	जड़े
jadav	जादव	जड़व
jaankaar	जानकार	जानकर
jankar	जानकार	जनकर
jaankaariyan	जानकारियां	जांकारियां
jankariyan	जानकारियां	जनकरियां
jaankaariyon	जानकारियों	जांकारियों
jaankariyon	जानकारियों	जांकारियों
jankariyon	जानकारियों	जनकारियों
jaankaari	जानकारी	जानकारी
jaankari	जानकारी	जानकरी
jankari	जानकारी	जनकरी
jaaniye	जानिए	जानिय
janiye	जानिए	जनिए
jaaneman	जानेमन	जानेमन
jaanemann	जानेमन	जानेमा
janeman	जानेमन	जनेमान
jaafarpur	जाफरपुर	जाफरपुर
jafarpur	जाफरपुर	जफरपुर
jaamwal	जामवाल	जामवाल
jamval	जामवाल	जामवल
jamwal	जामवाल	जमवाल
jaame	जामे	जामे
jame	जामे	जमे
jayal	जायल	जायल
joyal	जायल	जॉयल
george	जार्ज	ज्योर
jarj	जार्ज	जर्ज
javadekar	जावड़ेकर	जवादेकर
javdekar	जावड़ेकर	जवदेकर
jaavid	जाविद	जाविद
javid	जाविद	जविद
jitane	जितने	जीतने
jitne	जितने	जीतने
jinak	जिनके	जिनक
jinake	जिनके	जिनके
jinke	जिनके	जिंके
jinaalay	जिनालय	जिनालय
jinalay	जिनालय	जिनलय
gypsion	जिप्सियों	जिप्सन
gypsiyon	जिप्सियों	जिपसियों
jimma	जिम्मा	जीम्मा
jimmaa	जिम्मा	जिम्मा
jian	जियान	जीन
jiyaan	जियान	जियान
jiyan	जियान	जियान
jiyo	जियो	जियो
giraffe	जिराफ	गिरफे
ge	जीई	जे
jee	जीई	जी
ji	जीई	जी
genee	जीनी	गेनी
jeenee	जीनी	जीनी
jini	जीनी	जीनी
jiyanpur	जीयनपुर	जियानपु
jivantata	जीवंतता	जीवनतात
jivantataa	जीवंतता	जीवनतात
jivantta	जीवंतता	जीवनत्त
jeevnon	जीवनों	जीवनों
jivano	जीवनों	जीवानो
jivanon	जीवनों	जीवनों
gsat	जीसैट	जसत
gset	जीसैट	जैसट
jut	जुट	जूट
jute	जुट	जूट
jute	जुटे	जूटे
judate	जुड़ते	जुड़ते
judte	जुड़ते	जुड़ते
judaas	जुडास	जुडास
judas	जुडास	जुडास
junshaan	जुनशान	जुनशान
junshan	जुनशान	जुनशान
jurmane	जुर्माने	जुरमाने
jurrat	जुर्रत	जुरात
julana	जुलना	जुलना
julanaa	जुलना	जुलना
julna	जुलना	जुलना
joodi	जूडी	जूड़
judi	जूडी	जुड़
julian	जूलियन	जुलिया
jm	जेएम	जेम
jedda	जेद्दा	जेड्डा
jen	जेन	जेन
zen	जेन	जेन
geoffrey	जेफरी	ज्फोफ
jefary	जेफरी	जेफरी
jeffery	जेफरी	जेफरी
jack	जैक	जैक
jackman	जैकमैन	जकमान
jackie	जैकी	जैकी
jacky	जैकी	जैकी
jackson	जैक्सन	जैकसन
jagger	जैगर	जगेर
jaigar	जैगर	जैगर
jaingranthon	जैनग्रंथों	जैंग्रांठो
jaingrnthon	जैनग्रंथों	जैंग्रनाथो
jaina	जैना	जैना
genion	जैनियों	जेनियों
jainiyon	जैनियों	जैनियों
jockey	जॉकी	जोकी
job	जॉब	जॉब
jo	जो	जो
jong	जोंग	जोंग
jokhimo	जोखिमों	जोखीमो
jokhimon	जोखिमों	जोखिमों
jodte	जोडते	जोड़त
jodtey	जोडते	जोड़त
jorte	जोडते	जोरते
jod	जोड़	जोड़
jodiyaan	जोड़ियां	जोडियां
jodiyan	जोड़ियां	जोडियां
jodi	जोड़ी	जोड़ी
jota	जोता	जोता
joshua	जोशुआ	जोषुआ
jauhar	जौहर	जौहर
jauhariyon	जौहरियों	जौहरियों
jauhari	जौहरी	जौहरी
gyandev	ज्ञानदेव	ज्ञानदेव
jvaare	ज्वारे	जवारे
jvare	ज्वारे	जवरे
jware	ज्वारे	जवरे
jhanjhari	झंझरी	झंझाड
jhadane	झडने	झड़न
jhadne	झडने	झड़न
jhadapon	झड़पों	झड़पों
jhapakana	झपकाना	झपकना
jhapkaanaa	झपकाना	झपकाना
jhapkana	झपकाना	झपकाना
jhar	झर	झा
zar	झर	ज़
jhadol	झाड़ोल	झड़ोल
jharol	झाड़ोल	झरोल
jhaapad	झापड़	झापड़
jhapad	झापड़	झपड़
jhalawad	झालावाड़	झलवाद
jhunjhalahat	झुंझलाहट	झुंझलहात
jhunjhamahat	झुंझलाहट	झुंझाहट
jhunjhlahat	झुंझलाहट	झुंझलहात
jhukana	झुकना	झुकना
jhukna	झुकना	झुकना
jhunjhunu	झुन्झुनू	झुंझुनु
jhelate	झेलते	झेलते
jhelte	झेलते	झेलते
jhonkane	झोंकने	झोंकने
jhonkne	झोंकने	झोंकने
jhola	झोला	झोला
jholi	झोली	झोली
takarata	टकराता	तकराता
takraata	टकराता	तकराता
takrata	टकराता	तकराता
takarane	टकराने	तकरणे
takraane	टकराने	तकराने
takrane	टकराने	तकरने
tatti	टट्टी	तत्ती
taanka	टांका	तांका
tanka	टांका	तांका
tanki	टांका	तंकी
taangne	टांगने	तांगने
tangane	टांगने	तंगने
tangne	टांगने	तंगने
tighten	टाइटन	टाइटे
titan	टाइटन	तीतन
titen	टाइटन	टीटें
tifun	टाइफून	तीफुन
typhoon	टाइफून	त्फ़ोह
timing	टाइमिंग	टिमिंग
town	टाऊन	टाउन
takia	टाकिया	ताकिया
takiya	टाकिया	तकिया
tata	टाटा	ताता
toilet	टायलेट	टॉइलेट
tylet	टायलेट	टाइलेट
tikata	टिकता	तिकता
tikta	टिकता	तिकता
tiktaa	टिकता	तिकता
ticker	टिकर	टिकर
tikar	टिकर	तीकर
teeki	टिकी	तीकी
tiki	टिकी	टिकी
teenteen	टिनटिन	तींतीन
tintin	टिनटिन	टिंटिन
tips	टिप्स	टिप्स
tibbi	टिब्बी	तिब्बी
tibby	टिब्बी	टिब्बी
timtimaate	टिमटिमाते	तिमतिमाते
timtimate	टिमटिमाते	टिमटिमेट
tkdl	टीकेडीएल	टैकडली
teach	टीच	तेच
tvs	टीवीएस	टीवीएस
tender	टेंडर	टेंडर
tendor	टेंडर	टेंडर
technical	टेक्निकल	टेक्नीकल
tedhi	टेढ़ी	तेधी
tenesi	टेनेसी	टेनेसी
tennessee	टेनेसी	टेनेसी
terence	टेरेंस	टरेंस
terrence	टेरेंस	टरेंस
testo	टेस्टों	टेस्टो
teston	टेस्टों	टेस्टन
testosteron	टेस्टोस्टेरॉन	टेस्टोस्टरों
testosterone	टेस्टोस्टेरॉन	टेस्टोस्टरों
tong	टोंग	टॉन
token	टोकन	टोके
totake	टोटके	टोटके
totke	टोटके	टोटके
tobacco	टोबेगो	टॉबकॉ
tobego	टोबेगो	टोबेगो
tune	ट्यून	तुने
tyun	ट्यून	त्यून
ttunar	ट्यूनर	तुनार
tuner	ट्यूनर	टुनर
trucko	ट्रकों	ट्रकॉ
truckon	ट्रकों	ट्रकॉन
tribute	ट्रिब्यूट	ट्रिब्टू
trim	ट्रिम	ट्रीम
tree	ट्री	ट्री
thappa	ठप्पा	थाप्प
thitholi	ठिठोली	थिथोली
ththoli	ठिठोली	थथोली
thukraakar	ठुकराकर	थुकराकर
thukrakar	ठुकराकर	थुकराकर
dakt	डक्ट	डकत
duct	डक्ट	डक्ट
dagmagane	डगमगाने	दगमगने
date	डटे	डेट
daten	डटे	डेट
dabara	डबरा	दबार
dabra	डबरा	दबरा
dabok	डबोक	डबोक
dove	डव	डो
dancers	डांसर्स	डांसर्स
dansers	डांसर्स	डांसर्स
dining	डाइनिंग	डिनिंग
doubt	डाउट	डब्ट
dought	डाउट	डाउट
download	डाउनलोड	डाउलनोड
downloading	डाउनलोडिंग	डाउलानिंग
downloding	डाउनलोडिंग	डाउलांडिंग
dakiya	डाकिया	दकीय
dabar	डाबर	डबर
dabur	डाबर	डबर
daynasoron	डायनासोरों	दयनासोरों
dinosauron	डायनासोरों	दिनोसौरों
dynasoro	डायनासोरों	डायनसोरो
dynasoron	डायनासोरों	द्यंसोरों
daalti	डालती	डालती
dalati	डालती	डालती
dalti	डालती	डालती
dala	डाला	डाला
daali	डाली	डाली
dali	डाली	डाली
dega	डिएगो	डेगा
diaego	डिएगो	डायेग
diago	डिएगो	डायगो
decaine	डिकेन	डिकैन
dicken	डिकेन	डिकन
diken	डिकेन	डिकेन
defensiv	डिफेंसिव	डिफेंसीव
defensive	डिफेंसिव	डिफेंसीव
delay	डिले	डेले
dele	डिले	डेले
drs	डीआरएस	ड्र्स
deo	डीईओ	डियो
dn	डीएन	डीएन
dth	डीटीएच	डीएची
dw	डीडब्ल्यू	डीवीी
ddt	डीडीटी	डीडीटी
dbs	डीबीएस	डीबीएस
deluxe	डीलक्स	डिल्क्
do	डु	डो
dubone	डुबोने	डबोन
dumra	डुमरा	दुम्र
doobkar	डूबकर	दूबकर
dubkar	डूबकर	दुबकर
data	डेट	डात
date	डेट	डेट
debt	डेट	डेब
dating	डेटिंग	डांगिं
dates	डेट्स	डेट्स
deputy	डेप्यूटी	डिपटीी
darias	डेरियस	डायरिस
darius	डेरियस	डायरिय
delivery	डेलिवरी	डेलिवरी
doctorate	डॉक्टरेट	डॉक्टराइ
doctret	डॉक्टरेट	डॉक्ट्रे
dodger	डोजर	डॉजर
doser	डोजर	डॉसर
donovan	डोनोवैन	दोनोवान
donpovain	डोनोवैन	दोनपोवे
domino	डोमिनो	डोमिनो
domain	डोमेन	डोमैन
domen	डोमेन	डोमेन
dolomite	डोलोमाइट	डॉलोमिट
dosa	डोसा	दोसा
drai	ड्राई	द्रै
dry	ड्राई	ड्री
dribble	ड्रिबल	ड्रब्ल
drible	ड्रिबल	ड्रिबल
drag	ड्रैग	ड्रैग
dhakana	ढकना	ढकना
dhakna	ढकना	ढकना
dhaaniyon	ढाणियों	धानियों
dhaniyon	ढाणियों	धनियों
dhaani	ढाणी	धानी
dhani	ढाणी	धनी
dhikala	ढिकाला	ढीकला
dheeth	ढीठ	धीठ
dhith	ढीठ	धीठ
dheelapan	ढीलापन	धीलापन
dhilapan	ढीलापन	धिलापन
dhoondhate	ढूंढते	ढूंढते
dhoondhnte	ढूंढते	ढूंधने
dhoondhte	ढूंढते	ढूंढते
dhundhate	ढूंढते	ढुंधते
dhundhte	ढूंढते	ढुंधते
dhoondha	ढूंढा	धूंढ़
dhundha	ढूंढा	धुंधा
dhoondhe	ढूंढे	ढूंढे
dhundhe	ढूंढे	ढूंढे
dhoondhen	ढूंढें	धूंधें
dhundhen	ढूंढें	धुंधेन
dholak	ढोलक	धोलक
tantrika	तंत्रिका	तंत्रिका
tantrikeeya	तंत्रिकीय	तंत्रिकीय
tantrikiy	तंत्रिकीय	तंत्रिकीय
tantriy	तंत्रिकीय	तंत्रिय
takdeer	तकदीर	तादकी
takdir	तकदीर	तादकी
taqdir	तकदीर	ताकड़
takali	तकली	तकली
takli	तकली	तकली
taki	तकी	ताक
tadaagi	तड़ागी	तदागी
tadagi	तड़ागी	तड़गी
tansukh	तनसुख	तंसुख
tanisha	तनीशा	तनिषा
tapasvini	तपस्विनी	तपस्वीनी
tapaswini	तपस्विनी	तपस्वीनी
tapsvini	तपस्विनी	तपस्वीनी
tabassum	तबस्सुम	तबसूम
tabssum	तबस्सुम	तबसूम
tabhi	तभी	तभी
tar	तर	ता
tarr	तर	ता
taraf	तरफ	तरफ
taraste	तरसते	तरस्त
tarsate	तरसते	तरसते
taraashne	तराशने	तराशने
tarshne	तराशने	तर्शने
tarasha	तराशा	तराशा
tarashi	तराशी	तराशी
tarkvaadi	तर्कवादी	तरकवादी
tarkvadi	तर्कवादी	तरकवादी
tarkwadi	तर्कवादी	तरकवाड़ी
tarko	तर्को	टार्क
talpade	तलपडे	तलपड़
talaashanaa	तलाशना	तलशाना
talashana	तलाशना	तलाशना
tale	तले	तले
talleen	तल्लीन	तल्लीन
tallin	तल्लीन	टल्लिन
taslim	तस्लीम	तस्लीम
taaki	ताकि	ताकी
taki	ताकि	ताकी
taajik	ताजिक	ताजिक
tajik	ताजिक	ताजिक
taajul	ताजुल	ताजुल
tajul	ताजुल	ताजुल
taatya	तात्या	तात्य
tattya	तात्या	तत्त्य
tatya	तात्या	तत्य
taapmaan	तापमान	तापमान
tapman	तापमान	तपमान
taarakol	तारकोल	टारकोल
taarkol	तारकोल	टारकोल
tarkol	तारकोल	टार्को
taarif	तारीफ़	तारीफ
tareef	तारीफ़	तरीफ
tarif	तारीफ़	तरीफ
taare	तारे	तारे
tare	तारे	तरे
taalaband	तालाबंद	तालबंद
talaband	तालाबंद	तलबंद
tikona	तिकोना	तिकोणा
tithi	तिथी	तीठी
timaahi	तिमाही	तिमाही
timahi	तिमाही	तिमही
timir	तिमिर	तिमिर
tirap	तिरप	तीरप
tirp	तिरप	तीरप
tiraskarat	तिरस्कृत	तिरस्करत
tiraskrit	तिरस्कृत	तिरस्कृत
tiraskrut	तिरस्कृत	तिरस्कृत
tirskrit	तिरस्कृत	तिरस्कृत
tisari	तिसरी	तिसरी
tisri	तिसरी	तिस्र
teerandaji	तीरंदाजी	तीरंदाजी
teerndaaji	तीरंदाजी	तीर्णदाज
tirandaji	तीरंदाजी	तिरंदाजी
tukka	तुक्का	तुक्का
tumne	तुमने	तुमने
tumhare	तुम्हारे	तुम्हारे
turkey	तुर्की	टुरके
turki	तुर्की	तुर्की
ten	तें	टेन
tendoo	तेंदू	टेंडू
tendu	तेंदू	तेंदु
tendukheda	तेंदूखेड़ा	तेंदुखेद
tejpur	तेजपुर	तेप्पु
tezpur	तेजपुर	तेप्चु
tejasvi	तेजस्वी	तेजस्वी
tejaswi	तेजस्वी	तेजस्वी
tejsvi	तेजस्वी	तेजस्वी
tejaab	तेजाब	तेजाब
tejab	तेजाब	तेजब
teliyon	तेलियों	तेलियों
teliy	तेलीय	टेलिय
teliya	तेलीय	टेलिय
tevar	तेवर	तेवर
tevaron	तेवरों	तेवरों
tevron	तेवरों	तेवरों
taiyab	तैयब	तैया
todna	तोडना	तोड़न
tota	तोता	तोता
toshi	तोषी	तोषी
taulane	तौलने	तौलान
taulne	तौलने	तौलने
taula	तौला	तौला
trilok	त्रिलोक	ट्रिलोक
thakakar	थककर	थकाक
thakkar	थककर	थक्क
thapthapane	थपथपाने	थप्थापन
thapthpane	थपथपाने	थप्थपने
thermal	थर्मल	थर्मल
thaati	थाती	थाती
thati	थाती	थटी
thaamne	थामने	थामने
thamne	थामने	थमने
theater	थिएटर	थीटर
theter	थिएटर	थीटर
thank	थैंक	थांक
thanks	थैंक्स	थंक्स
thnaks	थैंक्स	थनक्स
thaila	थैला	थैला
thela	थैला	थेला
thailiyaan	थैलियां	थैलियां
thailiyan	थैलियां	थैलियां
thailiyon	थैलियों	थैलियों
thailon	थैलों	थैलों
thomas	थोमस	थोमस
thrast	थ्रस्ट	थ्रस्त
thrust	थ्रस्ट	थ्रस्ट
three	थ्री	थ्री
dange	दंगे	डंगे
dand	दंत	डैं
dant	दंत	डें
dakkan	दक्कन	दककन
dagaabaaja	दगाबाज	दगाबाज
dagabaaj	दगाबाज	दगबाज
dagabaj	दगाबाज	दगबाज
dagabaja	दगाबाज	दगबाजा
dan	दन	दा
dafanai	दफनाई	दफनाई
dafnaai	दफनाई	दफनाई
dafnaayi	दफनाई	दफनाई
damyanti	दमयंती	दम्यंत
damit	दमित	डमित
darvaajaa	दरवाजा	दरवाजा
darvaja	दरवाजा	दरवाजा
darwaja	दरवाजा	दरवाजा
daras	दरस	दरस
dariyaai	दरियाई	दरियाई
dariyai	दरियाई	दरियाई
dariapur	दरियापुर	दरियापुर
dariyapur	दरियापुर	दरियापुर
dariba	दरीबा	दरीबा
darjan	दर्जन	दरजन
darre	दर्रे	डरे
darshae	दर्शाई	दर्शाए
darshaee	दर्शाई	दर्शाई
darshai	दर्शाई	दर्शाई
dal	दल	डा
dalbeer	दलबीर	दलबीर
dalbir	दलबीर	दलबीर
dalel	दलेल	डाले
dalele	दलेल	डाले
dalon	दलों	डालो
dashahra	दशहरा	दशहरा
dashara	दशहरा	दशरा
dussehra	दशहरा	दुशेर
dashansh	दशांश	दशनश
dastaane	दस्ताने	दस्ताने
dastane	दस्ताने	डस्ताने
dastaveji	दस्तावेजी	दस्तावेजी
dastveji	दस्तावेजी	दस्तवेजी
dastavejon	दस्तावेजों	दस्तावेजों
dahak	दहक	दहक
dahala	दहला	दहला
dahalaa	दहला	दहला
dahla	दहला	दहला
dadar	दादर	दादर
daam	दाम	डाम
daaman	दामन	दामन
daman	दामन	दमन
daamaad	दामाद	दामाद
damad	दामाद	दमड़
damini	दामिनी	दमीनी
daamon	दामों	डामों
damon	दामों	डमों
daal	दाल	डाल
dal	दाल	डाल
daalee	दाली	दाली
daali	दाली	डाली
dalee	दाली	डाली
dali	दाली	डाली
daalon	दालों	दालों
dalo	दालों	डालो
dalon	दालों	डालों
daahsanskar	दाहसंस्कार	दाहसंस्कर
dahsanskar	दाहसंस्कार	दहसंस्कर
dahine	दाहिने	दहीने
digambar	दिंगबर	दिगंबर
dingabar	दिंगबर	दिंगबा
dingbar	दिंगबर	डिंगबर
digar	दिगर	डिगर
dinajpur	दिनाजपुर	दिनजपुर
dinakpur	दिनाजपुर	दिनकपुर
dimaag	दिमाग	दिमाग
dimag	दिमाग	डिमग
dimaagi	दिमागी	दिमागी
dimagi	दिमागी	दिमागी
dimaagon	दिमागों	दीमागों
dimagon	दिमागों	डिमागों
diyaas	दियास	दियास
diyas	दियास	दियास
diljale	दिलजले	दिलजाल
dilvaaye	दिलवाए	दिलवाए
dilvae	दिलवाए	दिलवाई
dilwaaye	दिलवाए	दिलवाए
dilwaye	दिलवाए	दिलवे
dilaaya	दिलाया	दिलाया
dilaya	दिलाया	दिलाया
dilayaa	दिलाया	दिलाया
dilaayi	दिलायी	दिलाई
dilayi	दिलायी	दिलाई
dilip	दिलीप	डिलिप
deen	दीन	डीन
din	दीन	डीन
deep	दीप	डीप
dip	दीप	डिप
deepa	दीपा	दीपा
dipa	दीपा	दीपा
diwaaliya	दीवालिया	दिवालिया
diwaliya	दीवालिया	दिवालिया
dukaan	दुकान	दुकान
dukan	दुकान	दुकान
dukaane	दुकानें	दुकाने
dukaanen	दुकानें	दुकानें
dukanen	दुकानें	डुकानें
dukh	दुख	दूख
dukha	दुख	दुख
dukhi	दुखी	दुखी
dugune	दुगुने	दुगुने
dughartna	दुघर्टना	दुघर्तना
durghatna	दुघर्टना	दुर्घातन
dutkaar	दुत्कार	दुतकार
dudhiya	दुधिया	दुधिया
dudhiyaa	दुधिया	दुधिया
dupatta	दुपट्टा	दुपत्ता
duptta	दुपट्टा	डुप्ता
dubai	दुबई	दुबै
dubaara	दुबारा	दुबारा
dubara	दुबारा	दुबरा
durruh	दुरूह	दुरूह
duruh	दुरूह	दुरूह
durghatnaon	दुर्घटनाओं	दुर्घाटनाओ
durghtnaon	दुर्घटनाओं	दुर्घटनाओं
dusre	दुसरे	डसरे
doosri	दूसरी	दूसरी
dusri	दूसरी	दुसरी
dradhataa	दृढ़ता	दृधता
dradhta	दृढ़ता	दृधता
dridhta	दृढ़ता	दृद्ता
deghaat	देघाट	देघात
deghat	देघाट	डेघाट
dete	देते	डेट
deodar	देवदार	देवार
devdaar	देवदार	देवदार
devdar	देवदार	देवदार
devidaas	देवीदास	देवीदास
devidas	देवीदास	देविदास
dainy	दैन्य	डैनी
dainya	दैन्य	दैन्य
daivagy	दैवज्ञ	डैवज्ञ
daivajny	दैवज्ञ	दैवाज्
daivgya	दैवज्ञ	दैवज्ञ
dogune	दोगुने	डोगुने
doharaane	दोहराने	दोहराने
doharane	दोहराने	दोहरणे
dohrane	दोहराने	दोहराने
daudane	दौड़ाने	दौड़ने
daulat	दौलत	दौलत
draupadi	द्रोपदी	दृपदी
dropadi	द्रोपदी	द्रोपदी
drohi	द्रोही	ड्रोही
dvadashi	द्वादशी	द्वाशाश
dwadashi	द्वादशी	द्वाशाई
davarpal	द्वारपाल	डवरपाल
dwarpal	द्वारपाल	द्वारपाल
davesh	द्वेश	दवेश
dvesh	द्वेश	द्वेष
dwesh	द्वेश	द्वेष
dhanda	धंधा	ढंडा
dhandha	धंधा	ढंधा
dhanarthi	धनार्थी	धनर्थी
dhani	धनी	धान
dhanop	धनोप	धनोप
dhabbe	धब्बे	ढब्बे
dharati	धरती	ढरात
dharti	धरती	ढरती
dharne	धरने	ढरने
dharma	धर्मा	धर्मा
dhaarakon	धारकों	धारकों
dharakon	धारकों	धरकों
dharkon	धारकों	धरकों
dhuandhar	धुंआधार	धुंधर
dhunaadhaar	धुंआधार	धुनाधार
dhunaadhar	धुंआधार	धुनाधर
dhunadhar	धुंआधार	धुनाधर
dhundhalapan	धुंधलापन	धुंधलापन
dhundhlapan	धुंधलापन	धुंधलापन
dhut	धुत	धुत
dhu	धू	धु
dhun	धून	धुन
dhuun	धून	धुं
dhumar	धूम्र	धुमार
dhumra	धूम्र	धुम्र
dhote	धोते	ढोते
dhyey	ध्येय	ध्ये
dhyeya	ध्येय	ध्येय
nange	नंगे	नंगे
nakum	नकुम	नकुम
naksalavaadiyon	नक्सलवादियों	नक्लावादियों
naksalwadiyon	नक्सलवादियों	नक्लावलायियो
naxalvaadiyon	नक्सलवादियों	नक्लावादियों
naxalwaadiyon	नक्सलवादियों	नक्लावलायों
naksalavaadi	नक्सलवादी	नक्लावादी
naksalvadi	नक्सलवादी	नक्लवादी
naxalvaadi	नक्सलवादी	नक्लावादी
naxalwaadi	नक्सलवादी	नक्लावाली
nageena	नगीना	नगीना
nagina	नगीना	नागिन
nach	नच	ना
najar	नजर	नजर
nazar	नजर	नज़
najariye	नजरिए	नजरीय
najrie	नजरिए	नज़ीर
najriye	नजरिए	नज़रि
nazarie	नजरिए	नज़री
najariye	नजरिये	नजरीय
najriye	नजरिये	नज़रिए
najrein	नजरें	नज़रे
najren	नजरें	नज़रे
najraana	नज़राना	नजराना
nazraana	नज़राना	नज़राना
nazrana	नज़राना	नज़राना
najd	नज्द	नजद
najda	नज्द	नजदा
nathu	नथु	नाथ
nabh	नभ	नभ
narita	नरिता	नरीता
narula	नरूला	नरूला
narega	नरेगा	नरेगा
naresh	नरेश	नरेश
nargis	नर्गिस	नार्जि
navtej	नवतेज	नवतेज
navbahaar	नवबहार	नवबहार
navbahar	नवबहार	नवबहर
navy	नव्य	नवी
navya	नव्य	नव्य
nasht	नष्ट	नश्त
nahae	नहाए	नहाई
nahaye	नहाए	नहाए
nice	नाइस	निस
nagesh	नागेश	नागेश
naachi	नाची	नाची
nachi	नाची	नाची
naacho	नाचो	नाचो
nacho	नाचो	नाचो
naate	नाते	नाते
nate	नाते	नेट
nanaki	नानकी	नानकी
nanki	नानकी	नंकी
nabaleeg	नाबालिग	नबलीग
nabalig	नाबालिग	नबलिग
nabaligon	नाबालिगों	नबलिगों
naabhi	नाभि	नाभी
nabhi	नाभि	नाभी
naamdan	नामदान	नामदान
namdan	नामदान	नमदान
naamroop	नामरूप	नामरूप
naamrup	नामरूप	नामरूप
namrup	नामरूप	नमरूप
namankan	नामांकन	नमनकान
namantaran	नामांतरण	नमंतरण
namumkin	नामुमकिन	नमुमकिन
naamon	नामों	नामों
namon	नामों	नमों
nayakon	नायकों	नायकों
narad	नारद	नारद
naraj	नाराज	नराज
naavikon	नाविकों	नाविकों
navikon	नाविकों	नवीकों
naashte	नाश्ते	नाश्ते
nashte	नाश्ते	नश्ते
nick	निक	एनआ
nik	निक	निक
nikaalate	निकालते	निकालते
nikaalte	निकालते	निकालते
nikalate	निकालते	निकलते
nikalte	निकालते	निकलते
nikharata	निखरता	निखरता
nikharataa	निखरता	निखरता
nikhara	निखरा	निखरा
nikharaa	निखरा	निखरा
nikhare	निखरे	निखरे
nikhaar	निखार	निखार
nikhar	निखार	निखर
nikhaaraa	निखारा	निखारा
nikhara	निखारा	निखरा
nigohi	निगोही	निगोही
nijaampur	निजामपुर	निजामपुर
nijampur	निजामपुर	निजामपुर
nizampur	निजामपुर	निजामपुर
nit	नित	नीट
niptaane	निपटाने	निपटाने
niptane	निपटाने	निपटाने
nibhaakar	निभाकर	निभाकर
nibhakar	निभाकर	निभाकर
nimna	निम्र	निम्न
nimr	निम्र	निम्र
nimra	निम्र	निम्र
niraksharata	निरक्षरता	निरक्षरता
niraksharataa	निरक्षरता	निरक्षरता
niraksharta	निरक्षरता	निरक्षरता
niraksharon	निरक्षरों	निरक्षरों
nirupama	निरुपमा	निरूपमा
nirupamaa	निरुपमा	निरूपमा
nirupma	निरुपमा	निरूपमा
nivaaran	निवारण	निवारण
nivaran	निवारण	निवरण
nivaaraniy	निवारणीय	निवारणीय
nivaaraniya	निवारणीय	निवारणीय
nivarniy	निवारणीय	निवरणीय
nivesh	निवेश	निवेश
niveshak	निवेशक	निवेशक
niveshakon	निवेशकों	निवेशकों
niveshit	निवेशित	निवेशित
niveshon	निवेशों	निवेशों
nishaadaraaj	निषादराज	निशादरज
nishadraj	निषादराज	निषाद्रज
nishdaraaj	निषादराज	निशदराज
nihaarati	निहारती	निहारती
nihaarti	निहारती	निहारती
neend	नींद	नींड
nind	नींद	निंड
neet	नीत	नीत
neeti	नीति	नीति
niti	नीति	निती
neetigat	नीतिगत	नीतिगत
nitigat	नीतिगत	नितिगत
neeraj	नीरज	नीरा
niraj	नीरज	निरा
neelaambar	नीलांबर	नीलांबा
nilaambar	नीलांबर	निलांबर
nilaanbr	नीलांबर	निलंबर
nilambar	नीलांबर	निलंबर
noo	नू	नू
nu	नू	नू
nrity	नृत्य	नृत्य
nritya	नृत्य	नृत्य
nrutya	नृत्य	नृत्य
naturopathy	नेचुरोपैथी	नतुरोपथ्य
net	नेट	नेट
netvest	नेटवेस्ट	नेटवेस्ट
netwest	नेटवेस्ट	नेटवेस्ट
nets	नेट्स	नेट्स
netaaon	नेताओं	नेताओं
netaon	नेताओं	नेताओं
netraheen	नेत्रहीन	नेत्रहीन
netrhin	नेत्रहीन	नेत्रहीन
namesake	नेमसेक	नमेसके
nemsek	नेमसेक	नेमसेक
neva	नेवा	नेवा
newa	नेवा	नेवा
newaa	नेवा	नेवा
nation	नेशन	नेशन
nairaashya	नैराश्य	नैराश्य
nairashy	नैराश्य	नैराश्य
nairashya	नैराश्य	नैराश्य
knock	नॉक	नोक
knorr	नॉर	नोर
nor	नॉर	नोर
nokia	नोकिया	नोकिया
nokha	नोखा	नोखा
nova	नोवा	नोवा
nautanki	नौटंकी	नौतंकी
notanki	नौटंकी	नोटंकी
nautan	नौतन	नौतन
pankchar	पंक्चर	पंचाड़
puncture	पंक्चर	पंक्चर
pankti	पंक्ति	पंक्ति
panktiyon	पंक्तियों	पंक्तियों
panchangon	पंचांगों	पंचांगों
punchangon	पंचांगों	पंचांगों
panchhiyon	पंछियों	पंचियों
panchiyon	पंछियों	पंचियों
panjabi	पंजाबी	पंजबी
punjabi	पंजाबी	पुंजबी
pandalon	पंडालों	पंदलों
pakate	पकते	पकते
pakte	पकते	पकते
paki	पकी	पाक
pakshapati	पक्षपाती	पक्षपाति
pakshpaati	पक्षपाती	पक्षपाति
pachranga	पचरंगा	पचरणगा
patak	पटक	पतक
pada	पड़ा	पड़ा
padaa	पड़ा	पड़ा
padegi	पड़ेगी	पड़ेगी
patila	पतीला	पटिला
patilaa	पतीला	पटिला
patniyaan	पत्नियां	पटनीयन
patniyan	पत्नियां	पत्नियां
pathari	पथरी	पथरी
pathri	पथरी	पथरी
pad	पद	पा
paday	पद्य	पड़ा
pady	पद्य	पाद्
padya	पद्य	पड़्
padhaaranaa	पधारना	पढ़ारण
padharana	पधारना	पढ़रणा
padharna	पधारना	पढ़रना
pappi	पप्पी	पापी
publication	पब्लिकेशन	पब्लिकेशन
parchhae	परछाई	परछाए
parchhai	परछाई	परछाई
parjiviyon	परजीवियों	पर्जीवियो
paran	परण	परण
parana	परण	परण
paratdaar	परतदार	परतदार
paratdar	परतदार	परतदार
pardes	परदेस	पार्ड
parnaanaa	परनाना	परणाना
parnana	परनाना	परनाना
parlok	परलोक	पर्लो
parawarti	परवर्ती	परावर्त
parvarti	परवर्ती	परवर्ती
parwarti	परवर्ती	परवर्ती
parvaan	परवान	परवाण
parvan	परवान	परवाण
parwaan	परवान	परवां
parasaad	परसाद	परसाद
parsaad	परसाद	परसाद
parsad	परसाद	परसद
paraajay	पराजय	पराजय
parajay	पराजय	पराजय
paraajayon	पराजयों	पराजयों
parajayon	पराजयों	पराजयों
paraatpar	परात्पर	परातपार
paratpar	परात्पर	परतपर
parikalp	परिकल्प	परिकल्प
parichaarikaa	परिचारिका	परिचारिका
paricharika	परिचारिका	परिचारिका
parimaan	परिमाण	परिमाण
parimana	परिमाण	परिमान
periman	परिमाण	परिमान
parimanaatmak	परिमाणात्मक	परिमाणात्मक
perimanatmak	परिमाणात्मक	पेरीमानत्मक
parivartansheel	परिवर्तनशील	परिवर्तनशील
parivartanshil	परिवर्तनशील	परिवर्तनशील
parishadein	परिषदें	परिशदें
parishaden	परिषदें	परिशदेन
parikshan	परीक्षण	परिक्षण
parikshanon	परीक्षणों	परिक्षणों
paroste	परोसते	परोस्ट
palaash	पलाश	पलाश
palash	पलाश	पलाश
palla	पल्ला	पल्ला
pallaa	पल्ला	पलाला
pulsar	पल्सर	पुलसर
pulser	पल्सर	पुलसर
pahnaanaa	पहनाना	पहनाना
pahnana	पहनाना	पहनना
pehnana	पहनाना	पहनना
pahalgaam	पहलगाम	पहलगाम
pahalgam	पहलगाम	पहलगाम
pahalvi	पहलवी	पहलवी
pahlavi	पहलवी	पहलाव
pehlavi	पहलवी	पहलाव
pahunchana	पहुंचना	पहुंचना
pahunchanaa	पहुंचना	पहुंचना
pahunchna	पहुंचना	पहुंचना
pahunchaayein	पहुंचाएं	पहुंचाएं
pahunchaen	पहुंचाएं	पहुंचाएं
pahunchayen	पहुंचाएं	पहुंचाएं
pahunchaati	पहुंचाती	पहुंचाती
pahunchati	पहुंचाती	पहुंचाती
paayegaa	पाएगा	पाएगा
payega	पाएगा	पाएगा
paao	पाओ	पाओ
pao	पाओ	पाओ
pachchajanya	पाञ्चजन्य	पच्चजन्ञ
pajjanya	पाञ्चजन्य	पज्ञान्य
panchjanya	पाञ्चजन्य	पंचजन्ञ
paapaa	पापा	पापा
papa	पापा	पापा
paayathan	पायथन	पाठान
pithan	पायथन	पिथन
python	पायथन	प्ठान
paaramparik	पारंपरिक	पार्पारि
paramparik	पारंपरिक	पारंपरिक
paranparik	पारंपरिक	परणपरिक
paardarshi	पारदर्शी	पार्दर्श
pardarshi	पारदर्शी	परदर्शी
paarasnaath	पारसनाथ	पारस्ना
parasnath	पारसनाथ	परस्थाथ
parliament	पार्लियामेंट	पार्लियामेंट
paashaatya	पाश्चात्य	पाशात्य
pakshatya	पाश्चात्य	पक्षत्य
paschatya	पाश्चात्य	पश्चत्य
paasing	पासंग	पासिं
pasang	पासंग	पासंग
picka	पिका	पिका
pika	पिका	पिका
pikaa	पिका	पिका
pictures	पिक्चर्स	पिक्चर्स
pixel	पिक्सेल	पिक्सेल
pig	पिग	पीग
pichhad	पिछड़	पिछड़
pichhar	पिछड़	पिछार
pichhada	पिछड़ा	पिछड़ा
pichhdaa	पिछड़ा	पिछड़ा
pichhadi	पिछड़ी	पिछड़ी
pichhdi	पिछड़ी	पिछड़ी
pichhaddepan	पिछड़ेपन	पिछड़ेपन
pichhadepan	पिछड़ेपन	पिछड़ेपन
pichhdepann	पिछड़ेपन	पिछ्देपन
pichheti	पिछेती	पिछेती
peer	पियर	पीर
pier	पियर	पीर
piyar	पियर	पियर
piere	पियरे	पिरे
pierre	पियरे	पिरेय
piyare	पियरे	पियरे
piro	पिरो	पीरो
pilaakar	पिलाकर	पिलाकर
pilakar	पिलाकर	पिलाकर
pet	पीईटी	पेट
pit	पीईटी	पीट
pgi	पीजीआई	पीजीआई
pds	पीडीएस	पीडीएस
peene	पीने	पीने
pine	पीने	पिने
pipaaji	पीपाजी	पिपाजी
pipaji	पीपाजी	पिपजी
pipipi	पीपीपी	पिपिपी
ppp	पीपीपी	पीपीपी
pucl	पीयूसीएल	पुक्ल
peace	पीस	पीस
peeskar	पीसकर	पीसका
piskar	पीसकर	पिस्क
pcr	पीसीआर	पीसीआर
putalon	पुतलों	पुतलों
putlon	पुतलों	पुतलों
pute	पुते	पुटे
punar	पुनर	पुनर
punaraavlokan	पुनरावलोकन	पुनरावलोकन
punaravalokan	पुनरावलोकन	पुनर्वलोकन
punravalochan	पुनरावलोकन	पुनरावलोचन
pushkar	पुष्कर	पुश्कर
pushpiy	पुष्पीय	पुष्पिय
pushpiya	पुष्पीय	पुष्पिय
poochhanaa	पूछना	पूछना
poochhnaa	पूछना	पूछना
puchna	पूछना	पुछना
poojyaneey	पूज्यनीय	पूज्ञानी
poojyaneeya	पूज्यनीय	पूज्ञानी
pujyaniy	पूज्यनीय	पुज्ञानि
poorana	पूराना	पूरण
puraanaa	पूराना	पुराना
purana	पूराना	पुराना
pus	पूस	पुस
puss	पूस	पुस
peticot	पेटीकोट	पेटिकॉट
petikot	पेटीकोट	पेटिकोट
petticoat	पेटीकोट	पेटिकॉट
petroleum	पेट्रोलियम	पेट्रोलियम
penalty	पेनल्टी	पेनलटी
peninsula	पेनिनसुला	पेनिंसला
paperwait	पेपरवेट	पापरवैत
paperweight	पेपरवेट	पेपरवेट
peptide	पेप्टाइड	पेप्टिड
payroll	पेरोल	पेरोल
peyroll	पेरोल	पेरोल
panth	पैंठ	पंथ
penth	पैंठ	पेंथ
packaging	पैकेजिंग	पैकेगिंग
paidaish	पैदाईश	पैदाश
pairodi	पैरोडी	पैरोडी
parody	पैरोडी	पारोडी
perodi	पैरोडी	पेरोडी
paishachi	पैशाची	पैशाची
polish	पॉलिश	पोलिश
pavel	पॉवेल	पेवल
powell	पॉवेल	पॉवल
pongal	पोंगल	पंगल
potash	पोटाश	पोटाश
pork	पोर्क	पोर्क
posalia	पोसालिया	पोसलिया
posaliya	पोसालिया	पोसलिया
posted	पोस्टेड	पॉस्टड
poha	पोहा	पोहा
paun	पौन	पौन
pauna	पौना	पौना
prakriyaon	प्रक्रियाओं	प्रकृतियों
prakshalan	प्रक्षालन	प्रक्षालन
prakshepit	प्रक्षेपित	प्रक्षेपित
prakhand	प्रखंड	प्रखंड
pragatisheel	प्रगतिशील	प्रगतिशील
pragatishil	प्रगतिशील	प्रगतिशील
pratadna	प्रताड़ना	प्रतान्न
pratapgarh	प्रतापगढ़	प्रताग्रह
prati	प्रति	प्रति
prti	प्रति	प्रति
pratikraman	प्रतिक्रमण	प्रतिक्रमण
pratikramana	प्रतिक्रमण	प्रतिक्रमण
pratikriyasheel	प्रतिक्रियाशील	प्रतिक्रियाशील
pratikriyashil	प्रतिक्रियाशील	प्रतिक्रियाशील
prtikriyashil	प्रतिक्रियाशील	प्रतिक्रियाशील
pratigyaon	प्रतिज्ञाओं	प्रतिज्ञाओं
prtigyaon	प्रतिज्ञाओं	प्रतिज्ञाओं
pratinidhatva	प्रतिनिधत्व	प्रतिनिधत्व
pratinidhitva	प्रतिनिधत्व	प्रतिनिधित्
prtinidhtv	प्रतिनिधत्व	प्रतिनिध्त्
pratinidhigan	प्रतिनिधिगण	प्रतिनिधिगन
pratinidhigana	प्रतिनिधिगण	प्रतिनिधिगन
prtinidhigan	प्रतिनिधिगण	प्रतिनिधिगन
pratinidhitva	प्रतिनिधित्व	प्रतिनिधित्व
prtinidhitv	प्रतिनिधित्व	प्रतिनिधित्व
prativadiyon	प्रतिवादियों	प्रतिवादियों
pratishodh	प्रतिशोध	प्रतिशोध
pratishthanon	प्रतिष्ठानों	प्रतिष्ठानों
pratispardha	प्रतिस्पर्द्धा	प्रतिस्पर्धा
pratispardhaein	प्रतिस्पर्धाएं	प्रतिस्पर्धाएं
pratispardhayein	प्रतिस्पर्धाएं	प्रतिस्पर्धाएं
pratispardhayen	प्रतिस्पर्धाएं	प्रतिस्पर्धाएं
pratyangira	प्रत्यंगिरा	प्रत्यंगिरा
prabhaavanaa	प्रभावना	प्रभावना
prabhavana	प्रभावना	प्रभावना
prabhaavshil	प्रभावशील	प्रभावशील
prabhavshil	प्रभावशील	प्रभावशील
prabhaas	प्रभास	प्रभास
prabhas	प्रभास	प्रभास
pramod	प्रमोद	प्रमोड
pravritt	प्रवृत्त	प्रवृत्त
pravrut	प्रवृत्त	प्रवृत
pravrutt	प्रवृत्त	प्रवृत्त
prashaasan	प्रशासन	प्रशासन
prashasan	प्रशासन	प्रशासन
prashikshuon	प्रशिक्षुओं	प्रशिक्षुओं
prasanskrat	प्रसंस्कृत	प्रसंस्कृत
prasanskrit	प्रसंस्कृत	प्रसंस्कृत
prasanskrut	प्रसंस्कृत	प्रसंस्कृत
prastaav	प्रस्ताव	प्रस्ताव
prastav	प्रस्ताव	प्रस्तव
prastaavit	प्रस्तावित	प्रस्तावित
prastavit	प्रस्तावित	प्रस्तावित
prastuti	प्रस्तुति	प्रस्तुति
pra	प्रा	प्र
praa	प्रा	प्रा
primary	प्राइमरी	प्रिमरी
praachinatam	प्राचीनतम	आ्रचिनताम
pracheenatam	प्राचीनतम	प्रचीनताम
prachintam	प्राचीनतम	प्रचिनताम
praniyon	प्राणियों	प्रणियों
pradhyapak	प्राध्यापक	प्रध्यापक
praptakarta	प्राप्तकर्ता	प्रपतकर्ता
praptkarta	प्राप्तकर्ता	प्रप्तकर्ता
praptiyon	प्राप्तियों	प्रप्तियों
praroopon	प्रारूपों	प्रूपों
prarupon	प्रारूपों	प्रारूपों
pravidhik	प्राविधिक	प्रविधिक
prince	प्रिंस	प्रिंस
princeli	प्रिंसली	प्रिंसली
princely	प्रिंसली	प्रिंसली
princle	प्रिंसली	प्रिंकल
preist	प्रीस्ट	प्रेस्ट
priest	प्रीस्ट	प्रीज्ट
prist	प्रीस्ट	प्रिस्ट
prekshak	प्रेक्षक	प्रेक्षक
premji	प्रेमजी	प्रेमजी
premanand	प्रेमानंद	प्रेमानंद
process	प्रॉसेस	प्रोसेस
pro	प्रो	प्रो
progressive	प्रोग्रेसिव	प्रोग्रेसिव
project	प्रोजैक्ट	प्रोजेक्ट
protocol	प्रोटोकोल	प्रोटोकल
produce	प्रोड्यूस	प्रोडक
producer	प्रोड्यूसर	प्रोडक्सर
property	प्रोपर्टी	प्रोपर्टी
profesion	प्रोफेशन	प्रोफेशन
profession	प्रोफेशन	प्रोफेशन
promot	प्रोमोट	प्रमोट
promote	प्रोमोट	प्रमोट
promotional	प्रोमोशनल	प्रमोशनल
prospects	प्रोस्पेक्टस	प्रोस्पेक्स
prospectus	प्रोस्पेक्टस	प्रोस्पेक्स
plug	प्लग	प्लग
plak	प्लाक	प्लाक
platinum	प्लेटिनम	प्लेटिनम
planon	प्लेनों	प्लानों
plenon	प्लेनों	प्लेनों
plot	प्लॉट	प्लोट
function	फंक्शन	फंक्शन
fundon	फंडों	फुंडो
funds	फंड्स	फंड्स
fantasi	फंतासी	फंतासी
fantasy	फंतासी	फैंटस्
fakharpur	फखरपुर	फखरपुर
fatafat	फटाफट	फटफात
fate	फटे	फटे
phate	फटे	फट
phte	फटे	फट
farar	फरार	फरार
pharar	फरार	फरार
farishey	फरिश्ते	फरिशे
farishte	फरिश्ते	फरिश्ते
farishtey	फरिश्ते	फरिश्ते
faldayak	फलदायक	फलदायक
phaldayak	फलदायक	फलदायक
farming	फार्मिंग	फार्मिंग
faalna	फालना	फालना
falna	फालना	फलना
fascist	फासिस्ट	फैस्सिस
fasist	फासिस्ट	फैस्ट
fastfood	फास्टफूड	फस्तफूड
fingers	फिंगर्स	फिंगर्स
fija	फिजा	फिजा
fiza	फिजा	फीजा
fizaa	फिजा	फिजा
fifteen	फिफ्टीन	फिफ्टीन
firki	फिरकी	फिरकी
filmana	फिल्माना	फिल्माना
fisal	फिसल	फिसल
fisle	फिसले	फिसले
fisley	फिसले	फिसले
feeka	फीका	फीका
fika	फीका	फिका
fikaa	फीका	फिका
feed	फीड	फीड
fu	फु	फू
phoo	फु	फू
footbal	फुटबल	फूटबल
football	फुटबल	फूटबल
futbal	फुटबल	फुटबा
furtili	फुर्तीली	फुर्तीली
fenkane	फेंकने	फेंकने
fenkne	फेंकने	फेंकने
phenkane	फेंकने	फेंकने
fentan	फेंटम	फेंटन
phantom	फेंटम	फैंटम
fefade	फेफड़े	फेफाड़
fefden	फेफड़े	फेफड़न
fame	फेम	फैम
fem	फेम	फेम
fallopian	फेलोपिन	फलोपियन
fallopine	फेलोपिन	फैलोपिन
felopin	फेलोपिन	फेलोपिन
falton	फेल्टन	फलतों
feltan	फेल्टन	फेल्टन
felton	फेल्टन	फेल्टन
faij	फैज	फैज
faiz	फैज	फैज
faiji	फैजी	फैजी
faizi	फैजी	फैजी
fabric	फैब्रिक	फेब्रिक
fairi	फैरी	फैरी
fairy	फैरी	फैरी
pheri	फैरी	फेरी
fail	फैल	फैल
failata	फैलता	फैलात
failataa	फैलता	फैलात
failta	फैलता	फैलता
failaayen	फैलाएं	फैलाएं
failaen	फैलाएं	फैलाएं
failayen	फैलाएं	फैलाएं
failaakar	फैलाकर	फैलाकर
failakar	फैलाकर	फैलाकर
fashionable	फैशनबल	फशिनोब
file	फॉइल	फीले
foil	फॉइल	फॉइल
fault	फॉल्ट	फॉल्ट
flat	फॉल्ट	फ्लेट
fog	फोग	फॉग
fobiya	फोबिया	फोबिया
phobia	फोबिया	फोबिया
fuse	फ्यूज	फुसे
funeral	फ्यूनरल	फुनरल
franchise	फ्रैंचाइज	फ्रांचाइज
flint	फ्लिंट	फ्लिंट
flintoff	फ्लिंटॉफ	फ्लिंटफ
flax	फ्लेक्स	फ्लैक्स
flex	फ्लेक्स	फ्लेक्स
flower	फ्लॉवर	फ्लोवर
bangla	बंग्ला	बंगला
banji	बंजी	बंजी
bungee	बंजी	बंगी
bandal	बंडल	बंदल
bundle	बंडल	बुंड
bandhu	बंधु	बंधु
bambe	बंबे	बंबे
bombay	बंबे	बोमब
bakra	बक्र	बकरा
baks	बक्स	बक्स
baksa	बक्स	बकसा
baksar	बक्सर	बकसर
buxar	बक्सर	बुक्र
bakson	बक्सों	बकसन
bakharband	बख्तरबंद	बखरबंद
bakhtarband	बख्तरबंद	खांतरबंद
bagair	बग़ैर	बागैर
bager	बग़ैर	बैगर
bagaawati	बगावती	बगावती
bagavati	बगावती	बगवती
bageecha	बगीचा	बगीचा
bagicha	बगीचा	बगीचा
bachata	बचता	बचात
bachta	बचता	बचता
bachtaa	बचता	बचता
bachate	बचते	बचात
bachte	बचते	बचते
bachaayen	बचाएं	बचाएं
bachaen	बचाएं	बचाएं
bachayen	बचाएं	बचाएं
bachayn	बचाएं	बचान्
bachaye	बचाये	बचाए
bacchan	बच्चन	बच्चन
bachchan	बच्चन	बच्चन
bacchon	बच्चों	बचों
bachchon	बच्चों	बच्चों
bachhon	बच्चों	बछों
bajrang	बजरंग	बजरंग
bajaai	बजाई	बजाई
bajai	बजाई	बजाई
bajaanaa	बजाना	बजाना
bajana	बजाना	बजना
baggika	बज्जिका	बगगीका
bajjika	बज्जिका	बज्जिका
badha	बढ़ा	बढ़ा
badhaayen	बढ़ाएं	बढ़ाएं
badhaen	बढ़ाएं	बढ़ाएं
badhayen	बढ़ाएं	बढ़ाएं
badhaani	बढ़ानी	बढ़ानी
badhani	बढ़ानी	बढ़नी
baataungaa	बताऊंगा	बातौंगा
bataunga	बताऊंगा	बतौंगा
bataaegi	बताएगी	बताएगी
bataayegi	बताएगी	बताएगी
bataegi	बताएगी	बताएगी
batayegi	बताएगी	बताएगी
bataashaa	बताशा	बताशा
batasha	बताशा	बताशा
badkismat	बदकिस्मत	बदकिस्मत
badami	बदामी	बदमी
badh	बध	बढ
badhaaiya	बधाईयां	बढ़ाया
badhaaiyaan	बधाईयां	धाईयां
badhaeiyan	बधाईयां	बढ़ाएं
badhaiya	बधाईयां	बढ़िया
badhiya	बधिया	बढ़िय
badhiyaa	बधिया	बढ़िय
banakata	बनकटा	बनाकत
bankata	बनकटा	बंकटा
banvaaye	बनवाए	बनवाए
banvae	बनवाए	बनवाई
banvaye	बनवाए	बनवाए
banaabat	बनाबट	बनाबत
banabat	बनाबट	बनबत
bnabat	बनाबट	बनाबत
baniae	बनिए	बनिए
banie	बनिए	बनी
baniye	बनिए	बनिय
baniyan	बनियान	बनियां
bani	बनी	बान
bano	बनो	बान
babita	बबिता	बाबित
babeena	बबीना	बबीना
babina	बबीना	बाबिन
barghat	बरघाट	बर्घा
barsate	बरसाते	बरसते
barsatein	बरसाते	बरसतें
barsana	बरसाना	बरसना
baramadon	बरामदों	बरामदों
baramdon	बरामदों	बरमदों
bari	बरी	बार
baretha	बरेठा	बरेथा
bretha	बरेठा	ब्रेठ
bareilly	बरेली	बैरली
bareli	बरेली	बरेली
barkali	बर्कली	बरकली
barklee	बर्कली	बरकली
barre	बर्रे	बरे
burre	बर्रे	बररे
balheen	बलहीन	बल्ही
balhin	बलहीन	बल्ही
balaat	बलात	बलात
balat	बलात	बलत
bali	बली	बली
balauda	बलौदा	बलौदा
balki	बल्की	बलकी
bulki	बल्की	बुल्क
bavandar	बवंडर	बावंद
bavander	बवंडर	बवांद
bawandar	बवंडर	बवांड
basai	बसई	बसा
basaav	बसाव	बसाव
basav	बसाव	बसव
baseda	बसेड़ा	बसेदा
bastar	बस्तर	बस्तर
baster	बस्तर	बस्टर
basta	बस्ता	बस्ता
bastiya	बस्तियां	बस्तिया
bastiyan	बस्तियां	बस्तियां
baste	बस्ते	बस्ते
bahroad	बहरोड़	बहरोद
bahrod	बहरोड़	बहरोद
bahate	बहाते	बहते
bahadurpur	बहादुरपुर	बहदुरपुर
bahirana	बहिराणा	बहिरणा
bahuvachan	बहुवचन	बहुवाच
bangla	बांग्ला	बंगला
bantate	बांटते	बांटते
binder	बाइंडर	बिंडर
baik	बाईक	बैक
bike	बाईक	बिके
bagara	बागरा	बगारा
bagaraa	बागरा	बगारा
bagra	बागरा	बगरा
baaga	बागा	बागा
baga	बागा	बगा
baaghi	बागी	बाघी
bagi	बागी	बागी
baagon	बागों	बागों
bagon	बागों	बगों
badhin	बाघिन	बाधीन
baghin	बाघिन	बाघीन
batala	बाटला	बताला
batla	बाटला	बतला
babari	बाबरी	बाबरी
babri	बाबरी	बार्ब
biotech	बायोटेक	बायोटेक
barahon	बारहों	बराहों
barhon	बारहों	बरहों
bariya	बारिया	बरिया
balaein	बालाएं	बलाएं
balaen	बालाएं	बलाएं
balayan	बालाएं	बलायन
balaon	बालाओं	बलाओं
baalaachandar	बालाचंदर	बालचंदर
balachandar	बालाचंदर	बलांचार
balasahab	बालासाहब	बलासाहब
balasaheb	बालासाहब	बलासहेब
baltic	बाल्टिक	बाल्टिक
baltik	बाल्टिक	बलतीक
baalyakaal	बाल्यकाल	बाल्यकाल
balyakal	बाल्यकाल	बलयाकाल
balykal	बाल्यकाल	बलयकल
bikharane	बिखरने	बिखरने
bikharne	बिखरने	बिखरने
bikhrane	बिखरने	बिखरने
bitta	बिट्टा	बित्ता
bitaate	बिताते	बिताते
bitate	बिताते	बिटते
bitaayaa	बिताया	बिताया
bitaya	बिताया	बिताया
birjiya	बिरजिया	बिरजीय
birsa	बिरसा	बिरसा
birsinghpur	बिरसिंहपुर	बिरसिंहपुर
bilkul	बिल्कुल	बिलकुल
bisht	बिष्ट	बिष्ट
bisauli	बिसौली	बिसौली
being	बीइंग	बेंग
bsl	बीएसएल	बीएल
beacon	बीकन	बीकॉ
beeken	बीकन	बीके
bikan	बीकन	बिकन
bds	बीडीएस	बीडीएस
bdsm	बीडीएसएम	ब्ड्सम
bimit	बीमित	बिमिट
bujhati	बुझती	बुझात
buzati	बुझती	बुजात
butati	बुटाटी	बुताती
budhana	बुढ़ाना	बुढ़ना
buddhi	बुद्धि	बुद्धि
bulldozer	बुलडोजर	बुल्डोज
buldhana	बुलढाना	बुलधना
bulakar	बुलाकर	बुलाकर
buliyan	बुलियन	बुलिया
buliyn	बुलियन	बुलियन
bullion	बुलियन	बुलियन
bulls	बुल्स	बुल्स
buls	बुल्स	बुल्स
beimaani	बेइमानी	बेमानी
beimani	बेइमानी	बेमानी
baig	बेग	बैग
beg	बेग	बेग
betool	बेतूल	बेटूल
betul	बेतूल	बेटल
babe	बेब	बबे
bemisaal	बेमिसाल	बेमिसाल
bemisal	बेमिसाल	बेमिसल
belt	बेल्ट	बेल्ट
belton	बेल्टों	बेल्टन
belts	बेल्ट्स	बेल्ट्स
besara	बेसरा	बेसरा
besraa	बेसरा	बेसरा
basinon	बेसिनों	बसीनों
besinon	बेसिनों	बेसिनों
basis	बेसिस	बासिस
besis	बेसिस	बेसिस
besure	बेसुरे	बेयूरे
banch	बैंच	बांच
bench	बैंच	बेंच
baikunth	बैकुंठ	बैकुंठ
baichen	बैचेन	बैचेन
bechain	बैचेन	बेचान
bechen	बैचेन	बेचें
batman	बैटमैन	बतमान
baitha	बैठा	बैठा
baithaa	बैठा	बैठा
bain	बैन	बैन
ban	बैन	बान
bainet	बैनेट	बैनेट
bennett	बैनेट	बेनेट
bail	बैल	बैल
bell	बैल	बेल
bailey	बैली	बैले
belly	बैली	बेली
bailon	बैलों	बैलों
bahr	बैहर	बहर
baihar	बैहर	बैहा
boxeron	बॉक्सरों	बॉक्सरों
batham	बॉथम	बथम
bathem	बॉथम	बथेम
botham	बॉथम	बोथम
boil	बॉयल	बोइल
boyal	बॉयल	बॉयल
boyle	बॉयल	बोले
boiler	बॉयलर	बोइलर
boyler	बॉयलर	बॉयलर
bodein	बोडेन	बोड़े
boden	बोडेन	बोड़न
botheil	बोथेल	बोथेल
bothel	बोथेल	बोथल
bodhgaya	बोधगया	बोधगाय
bodhgya	बोधगया	बोधग्य
bofors	बोफोर्स	बॉफोर्स
boro	बोरो	बोरो
boron	बोरोन	बोरों
bordo	बोर्दो	बोर्डो
borno	बोर्नो	बोर्नो
bola	बोला	बोला
bolero	बोलेरो	बोलरो
bowlero	बोलेरो	बोलरो
bostan	बोस्टन	बोस्ता
boston	बोस्टन	बोस्टन
brahamini	ब्रह्माणी	ब्रह्मणी
brahmani	ब्रह्माणी	ब्रह्मणी
bridesmaid	ब्राइड्समेड	ब्रिडेजमैड
bridesmaids	ब्राइड्समेड	ब्रिडेजमैड्
brai	ब्राई	ब्रेई
brie	ब्राई	ब्री
bradley	ब्रेडले	ब्रेडली
bradley	ब्रैडली	ब्रेडली
bradli	ब्रैडली	ब्रदली
bro	ब्रो	ब्रो
broking	ब्रोकिंग	ब्रोकिंग
bromavich	ब्रोमविच	ब्रोमावि
bromvich	ब्रोमविच	ब्रमविच
bromwitch	ब्रोमविच	ब्रमविच
bluetooth	ब्लूटूथ	ब्लूटूथ
bloggaron	ब्लॉगरों	ब्लोगारो
bloggeron	ब्लॉगरों	ब्लॉगरों
bluetooth	ब्ल्यूटूथ	ब्लूटूथ
bhante	भंते	भांत
bhagavad	भगवद	भगवा
bhagvad	भगवद	भगवा
bhanak	भनक	भान
bhayatur	भयातुर	भयतूर
bhayaanak	भयानक	भयानक
bhayanak	भयानक	भयनक
bharat	भरत	भरत
bharata	भरता	भरता
bharataa	भरता	भरता
bharta	भरता	भरता
bharati	भरती	भरती
bharti	भरती	भरती
bharsak	भरसक	भरसक
bharai	भराई	भराई
bhavae	भवाई	भावे
bhavai	भवाई	भावा
bhavishyavaaniyaan	भविष्यवाणियां	भविष्यवाणीयन
bhavishyavaniyan	भविष्यवाणियां	भविष्यवाणीयन
bhavishyavaaniyon	भविष्यवाणियों	भविष्यवाणियों
bhavishyavaniyon	भविष्यवाणियों	भविष्यवाणियों
bhasin	भसीन	भासी
bhau	भाऊ	भौ
bhakri	भाकरी	भक्री
bhaagate	भागते	भागते
bhagate	भागते	भगते
bhagirathi	भागीरथी	भगीरथी
bhaagya	भाग्य	भाग्य
bhagy	भाग्य	भाग्य
bhagya	भाग्य	भाग्य
bhabhi	भाभी	भाभी
bhaar	भार	भार
bhar	भार	भर
bhale	भाले	भाले
bhalekar	भालेकर	भालेकर
bhavnaein	भावनाएं	भवनाएं
bhavnaen	भावनाएं	भवनाएं
bhavnayn	भावनाएं	भावनाएं
bhaskaran	भास्करन	भासकरण
bhaskran	भास्करन	भास्करण
bhilala	भिलाला	भिलाला
bheetar	भीतर	भीतर
bhitar	भीतर	भितर
bheetari	भीतरी	भीतरी
bhitari	भीतरी	भितरी
bhitri	भीतरी	भित्र
bheer	भीर	भीर
bhir	भीर	भीर
bhugatata	भुगतता	भुगतात
bhugatta	भुगतता	भुगत्त
bhugtata	भुगतता	भुगतात
bhugatana	भुगतना	भुगतान
bhugtna	भुगतना	भुगतना
bhgti	भुगती	भगती
bhugati	भुगती	भुगती
bhugti	भुगती	भुगती
bhuj	भुज	भुज
bhulaakar	भुलाकर	भुलाकर
bhulakar	भुलाकर	भुलकर
bhookhaa	भूखा	भूखा
bhukha	भूखा	भुखा
bhukhaa	भूखा	भुखा
bhookhe	भूखे	भूखे
bhukhe	भूखे	भुखे
bhookhon	भूखों	भूखों
bhukhon	भूखों	भुखों
bhoochaal	भूचाल	भूचल
bhuchal	भूचाल	भुचल
bhootha	भूतहा	भूठा
bhutaha	भूतहा	भुताह
bhuri	भूरी	भुरी
bhool	भूल	भूल
bhul	भूल	भुल
bhulate	भूलते	भुलते
bhulte	भूलते	भुलते
bhulane	भूलने	भुलान
bhulne	भूलने	भुलने
bhoosanptti	भूसंपत्ति	भूसंपत्ति
bhusampatti	भूसंपत्ति	भूसंपत्ति
bheje	भेजे	भेजे
bhejegi	भेजेगी	भेजेगी
bhejogi	भेजेगी	भेजोगी
bhaiyadooj	भैयादूज	भैयादूज
bhotiya	भोटिया	भोतिया
bhaunra	भौंरा	भौनरा
bhraantiya	भ्रांतिया	भ्रांतीय
bhrantiya	भ्रांतिया	भ्रांतिया
mangvana	मंगवाना	मंगवाना
mangwana	मंगवाना	मंगवाना
mangoliyan	मंगोलियन	मंगोलिया
mongolian	मंगोलियन	मंगोलियन
manchan	मंचन	मांच
manjili	मंजिली	मंजीली
majilein	मंजिले	मजीलें
manjile	मंजिले	मंजीले
manzile	मंजिले	मंजीले
manjilon	मंजिलों	मंजीलों
manzilon	मंजिलों	मंजीलों
manjeere	मंजीरे	मंजीरे
manjeerey	मंजीरे	मंजीरे
manjire	मंजीरे	मंजीरे
manjul	मंजुल	मंजुल
mantra	मंत्र	मंत्र
mantrigan	मंत्रीगण	मंत्रिगन
mantron	मंत्रों	मंत्रों
mantrocchar	मंत्रोच्चार	मंत्रोचार
mantrochchar	मंत्रोच्चार	मंत्रोच्चर
manth	मंथ	मंथ
month	मंथ	मों
mahanga	मंहगा	महंगा
manhaga	मंहगा	मनहाग
mehnga	मंहगा	मेंहग
makbul	मकबूल	मकबूल
maqbool	मकबूल	मकबूल
makode	मकोड़े	मकड़े
makkari	मक्कारी	मककरी
machhua	मछुआ	मछुआ
machhuaaraa	मछुआरा	मछुआरा
machhuara	मछुआरा	मछुआरा
majumdar	मजूमदार	मजुमदार
mazumdaar	मजूमदार	मजुमदार
majedaar	मजेदार	मजेदार
majedar	मजेदार	मजेदार
mazedaar	मजेदार	मजेदार
madiyahun	मडियाहूं	मदियाहुन
mariahu	मडियाहूं	मारीह
mariahun	मडियाहूं	मरीहुन
madhi	मढ़ी	मधी
madi	मढ़ी	माड़
matdata	मतदाता	मतड़ता
matsy	मत्स्य	मैस्टी
matsya	मत्स्य	मत्स्य
mathai	मथाई	मठाई
madad	मदद	मदद
madarason	मदरसों	मदरसों
madarson	मदरसों	मादर्स
madrason	मदरसों	मदरसों
madde	मद्दे	मद्दे
midday	मद्दे	मिड्ड
madhurika	मधुरिका	मधुरिका
madhuresh	मधुरेश	मधुरेश
madhuban	मधुवन	मधुबा
madhuvan	मधुवन	मधुवा
madhesh	मधेश	मधेश
manmaana	मनमाना	मनमाना
manmana	मनमाना	मनमाना
manhoos	मनहूस	मैनहू
manhus	मनहूस	मैनहु
manaya	मनाया	मनाया
manoj	मनोज	मनोज
manonayan	मनोनयन	मनोनयन
manonyan	मनोनयन	मनोन्य
mamata	ममता	मामत
mamta	ममता	मामत
maran	मरण	मरण
maryam	मरयम	मर्य
marathaon	मराठाओं	मराथाओं
mard	मर्द	मर्ड
malyali	मलयाली	मलयाली
mashad	मशद	मशा
masakaja	मसाकाजा	मसाकाजा
masaj	मसाज	मसाज
massage	मसाज	मसेज
masalon	मसालों	मसलों
masudanpur	मसुदनपुर	मसुदानपु
masuri	मसूरी	मसूरी
mussoorie	मसूरी	मुसूर
mahal	महल	महल
mahakashyap	महाकाश्यप	महाकाश्या
mahakasyap	महाकाश्यप	महाकास्यप
mahakaushal	महाकौशल	महाकाशल
mahakoshal	महाकौशल	महकोषल
mahaganpati	महागणपति	महागनपति
mhaganpati	महागणपति	महागनपति
mahadeshiy	महादेशीय	महादेशीय
mhadeshiy	महादेशीय	महादेशीय
mahabharat	महाभारत	महभरत
mhabharat	महाभारत	महाभरत
maharajaon	महाराजाओं	महाराजाओं
maharana	महाराणा	महराना
mahavidhyaon	महाविद्याओं	महाविद्याओं
mahavidyaon	महाविद्याओं	महाविद्याओं
mahashay	महाशय	महाशय
mahashaye	महाशय	महाशय
mahashamshan	महाश्मशान	महाशमशान
mahashmashaan	महाश्मशान	महाश्मशान
mahashmshan	महाश्मशान	महाश्मशान
mahasagar	महासगर	महासाग
mahasgar	महासगर	महासगर
mahasamadhi	महासमाधि	महासमधी
mahina	महीना	महिना
mahesh	महेश	महेश
maangta	मांगता	मांगता
mangata	मांगता	मंगता
mangta	मांगता	मंगता
maange	मांगें	मांगे
mangein	मांगें	मंगें
mangen	मांगें	मंगें
maangon	मांगों	मांगों
mangon	मांगों	मंगों
mouth	माउथ	मौथ
madal	माडल	मदल
model	माडल	मोडल
maandaley	माण्डले	मांडले
mandale	माण्डले	मंडले
mandel	माण्डले	मंडेल
maatang	मातंग	माटंग
matang	मातंग	मांटन
manasik	मानसिक	मानसिक
mansik	मानसिक	मानसिक
mansikata	मानसिकता	मानसिकता
mansikta	मानसिकता	मानसिकता
maanegaa	मानेगा	मानेगा
manega	मानेगा	मनेगा
maapata	मापता	मापता
mapata	मापता	मापता
mapta	मापता	मापता
maape	मापे	मापे
mape	मापे	मापे
maaf	माफ	माफ
maf	माफ	मफ
maarte	मारते	मारते
maartey	मारते	मारते
marte	मारते	मरते
maalikana	मालिकाना	मालिकना
malikana	मालिकाना	मलिकनाा
maasi	मासी	मासी
masi	मासी	मसी
masoom	मासूम	मसूम
masum	मासूम	मसूम
masoomon	मासूमों	मसूमों
masumon	मासूमों	मसूमों
mahul	माहुल	महुल
mahaul	माहौल	महौल
mauritious	माॅरिशस	मॉरिशस
moreshes	माॅरिशस	मोरेश्स
moresis	माॅरिशस	मोरेसिस
michalaane	मिचलाने	मिचलाने
michlaaney	मिचलाने	मिचलाने
michlane	मिचलाने	मिचलाने
mitaanaa	मिटाना	मिताना
mitana	मिटाना	मिटाना
mithaaiyon	मिठाईयों	मिथाईयों
mithaiyon	मिठाईयों	मिथायों
mithilesh	मिथिलेश	मिथिलेश
mimi	मिमी	मिमी
miljulakar	मिलजुलकर	मिलजुलकर
miljulkar	मिलजुलकर	मिलजुलकर
milind	मिलिंद	मिलिंड
milibhagat	मिलीभगत	मिलीभगत
misaalein	मिसालें	मिसालें
misale	मिसालें	मिसले
misalein	मिसालें	मिसलें
me	मी	मे
mee	मी	मी
meeji	मीजी	मीजी
miji	मीजी	मिजी
meat	मीट	मेट
meet	मीट	मीट
medium	मीडियम	मेडियम
meeta	मीता	मीटा
mita	मीता	मिटा
mungeir	मुंगेर	मंगेर
munger	मुंगेर	मंगर
munshi	मुंशी	मुंशी
moonh	मुंह	मूंह
muh	मुंह	मुह
munh	मुंह	मुंह
mukesh	मुकेश	मुकेश
mukhaute	मुखौटे	मुखौते
mukhautey	मुखौटे	मुखौते
mukhtaar	मुख्तार	मुखतर
mukhtar	मुख्तार	मुखतर
mukhyetaar	मुख्तार	मुख्यता
mukhya	मुख्य	मुख्य
mukhye	मुख्य	मुख्य
mukhyamantritva	मुख्यमंत्रित्व	मुख्यमंत्रित्व
mukhyamantriyon	मुख्यमंत्रियों	मुख्यमंत्रियों
mugabe	मुगाबे	मुगबे
mugabey	मुगाबे	मुगबे
muchalka	मुचलका	मुचलका
muchlaka	मुचलका	मुचलाक
muchlka	मुचलका	मुचलका
mutthi	मुट्ठी	मुत्थी
mudane	मुड़ने	मुदाने
mudne	मुड़ने	मुडने
mudit	मुदित	मुदित
mudraein	मुद्राएं	मुद्राएं
mudraen	मुद्राएं	मुद्राएं
munafe	मुनाफे	मुनफे
munafey	मुनाफे	मुनफे
munaphe	मुनाफे	मुनाफे
munirka	मुनिरका	मुनिरका
mursi	मुर्सी	मुर्सी
mosammi	मुसम्मी	मोसम्मी
musammi	मुसम्मी	मुसम्मी
musolini	मुसोलिनी	मुसोलिनी
mussolini	मुसोलिनी	मुसोलीनि
moo	मू	मू
mu	मू	मू
moods	मूड्स	मूड्स
mool	मूलं	मूल
mooln	मूलं	मूलन
mulam	मूलं	मुला
moolbhoot	मूलभूत	मूलभूत
mulbhoot	मूलभूत	मुलभूत
mulbhut	मूलभूत	मुलभुत
moolmantra	मूलमंत्र	मूलमंत्र
mulmantr	मूलमंत्र	मूलमंत्र
mulmantra	मूलमंत्र	मुलमंत्र
moolvasiyon	मूलवासियों	मूलवासियों
mulwasiyon	मूलवासियों	मुलवासियों
mulyvasiyon	मूलवासियों	मुल्यवसियो
mooli	मूली	मूली
muli	मूली	मूली
mentha	मेंथा	मेंथा
mens	मेंस	मेंस
megan	मेगान	मेगन
mejbaanon	मेजबानों	मेजबानों
mejbanon	मेजबानों	मेजबानों
mezbanon	मेजबानों	मेबंबन
menaka	मेनका	मेनका
menka	मेनका	मेंका
mera	मेरा	मेरा
meraa	मेरा	मेरा
meltan	मेल्टन	मेलतान
melton	मेल्टन	मेल्टन
mevaadi	मेवाड़ी	मेवाड़ी
mewadi	मेवाड़ी	मेवाड़ी
mehmood	मेहमूद	मेहमूड
mehmud	मेहमूद	मेहमूड
mantle	मैंटल	मंटल
mental	मैंटल	मेंटल
mandarin	मैंडरिन	मंडरीन
maine	मैंने	मैने
magazine	मैगजिन	मैगजीन
magzine	मैगजिन	मैजजीन
magnus	मैगनस	मैग्न
maglev	मैगलेव	मैगलेव
magnus	मैग्नस	मैग्नस
magras	मैग्नस	मगरस
matric	मैट्रिक	मैट्रिक
mads	मैड्स	मैड्स
maitra	मैत्रा	मैत्र
matra	मैत्रा	मत्र
mankind	मैनकाइंड	मैंकिंड
maini	मैनी	मैनी
mainy	मैनी	मैनी
many	मैनी	मान्
manu	मैन्यू	मनु
menu	मैन्यू	मेनू
maiya	मैया	मैया
maiyya	मैया	मैय्
mailkam	मैलकम	मैलकम
malcolm	मैलकम	मैकलॉ
maish	मैश	मैश
mash	मैश	मश
mesh	मैश	मेश
modular	मॉड्यूलर	मोदुलर
modakar	मोड़कर	मोडकर
modkar	मोड़कर	मोडकर
modate	मोड़ते	मोड़ते
modte	मोड़ते	मोड़ते
modane	मोड़ने	मोड़ने
modne	मोड़ने	मोडने
motipur	मोतीपुर	मोटीपुर
motiram	मोतीराम	मोटिराम
monal	मोनल	मोनल
monash	मोनाश	मोनाश
monitor	मोनिटर	मोनिटर
mom	मोम	मोम
morakkan	मोरक्कन	मोरक्कन
morkkan	मोरक्कन	मोरक्कन
moroccan	मोरक्कन	मोरक्सन
moravi	मोरवी	मोराव
morvi	मोरवी	मोरवी
morwi	मोरवी	मोरवी
molar	मोलर	मोलर
moler	मोलर	मोलर
mola	मोला	मोला
moli	मोली	मोली
molding	मोल्डिंग	मॉल्डिंग
mohak	मोहक	मोहक
maidrik	मौद्रिक	मैद्रीक
maudrik	मौद्रिक	मौद्रिक
maureen	मौरीन	मौरीन
maurin	मौरीन	मौरीन
maurya	मौर्य	मौर्य
morya	मौर्य	मोर्य
maula	मौला	मौला
maulik	मौलिक	मौलिक
maulikata	मौलिकता	मौलिकता
maulikta	मौलिकता	मौलिकता
mhari	म्हारी	महारी
yateem	यतीम	याती
yatim	यतीम	याति
yadi	यदि	याद
yashvardhan	यशवर्धन	यश्वर्ध
yathavardhan	यशवर्धन	यथावर्ध
yashomati	यशोमति	यशोमती
yahi	यही	यही
yangon	यांगोन	यंगों
yatayat	यातायत	यातायत
yaar	यार	यार
yaaron	यारों	यारों
yugmon	युग्मों	युगमों
yunus	युनूस	यूनस
yun	यूं	यून
uid	यूआईडी	यूईी
usda	यूएसडीए	उसदा
utc	यूटीसी	यूटीसी
youth	यूथ	यूथ
united	यूनाईटेड	यूनिटेड
up	यूपी	ऊप
ulip	यूलिप	उलिप
yulip	यूलिप	यूलिप
yale	येल	याल
yel	येल	येल
york	यॉर्क	योरक
yogaphal	योगफल	योगफल
yogfal	योगफल	योगफल
yohaan	योहान	योहान
yohan	योहान	योहान
rangrashiya	रंगरसिया	रंग्रशिय
rangrasia	रंगरसिया	रंग्रासि
rangrasiya	रंगरसिया	रंग्रासि
rangaroop	रंगरूप	रंगरूप
rangarup	रंगरूप	रंगरूप
rangroop	रंगरूप	रंग्रू
rangrup	रंगरूप	रंग्रु
rangarang	रंगारंग	रंगरणग
raeersi	रईसी	रीयर
raees	रईसी	रीज
raisi	रईसी	रैसी
raerson	रईसों	रेयरस
raeson	रईसों	रायसन
raison	रईसों	रैसों
rakhoge	रखोगे	रखोगे
rakhogey	रखोगे	रखोगे
raghukul	रघुकुल	रघुकुल
ranneetik	रणनीतिक	रणनीतिक
rannitik	रणनीतिक	रणनीतिक
runner	रनर	रून
rane	रने	रान
runey	रने	रून
rapat	रपट	रपट
rapton	रपटों	रप्तो
rafeek	रफीक	रफीक
rafiq	रफीक	राफि
ramadan	रमदान	रामाद
ramdan	रमदान	रामदा
rasana	रसना	रसना
rasanaa	रसना	रसना
rasna	रसना	रसना
rasam	रसम	रसम
rasaayan	रसायन	रसायन
rasayan	रसायन	रसायन
rasyan	रसायन	रस्या
rasta	रस्ता	रस्ता
rahanumaee	रहनुमाई	रहनुमाई
rahnumai	रहनुमाई	रहनुमाई
rhanumai	रहनुमाई	रहनुमै
riders	राइडर्स	रिडर्स
raima	राइमा	रैमा
round	राउंड	राउंड
rounds	राउंड्स	राउंड्स
router	राउटर	रॉटर
rakesh	राकेश	रकेश
raakh	राख	राख
rakh	राख	रख
raakhiyaan	राखियां	राखियां
rakhiyan	राखियां	रखीयन
rakhiyon	राखियों	रखियों
rakhi	राखी	रखी
raakhein	राखें	राखें
rakhen	राखें	रखें
raag	राग	राग
rag	राग	रग
raagi	रागी	रागी
ragi	रागी	रगी
raghav	राघव	रघव
raghavanand	राघवानंद	रघवांड
raghawanand	राघवानंद	रघवानंद
rajkaran	राजकरण	राजकरण
rajtantriya	राजतंत्रीय	राजतंत्रिय
rajdroh	राजद्रोह	राजदोह
rajdroha	राजद्रोह	राजदोहा
raajnetik	राजनेतिक	राजनेतिक
rajnaitik	राजनेतिक	राजनैतिक
rajnetik	राजनेतिक	राजनेतिक
rajbaag	राजबाग	राजबाग
rajbag	राजबाग	राजबाग
rajbagh	राजबाग	राजबाग
rajbaug	राजबाग	राजबौग
rajendranagar	राजेंद्रनगर	राजेंद्रनगर
rajya	राज्य	राज्य
raajyon	राज्यों	राज्यों
rajyon	राज्यों	राज्यों
rathava	राठवा	रथवा
rathwa	राठवा	रावथा
raatribhoj	रात्रिभोज	रात्रिभोज
ratribhoj	रात्रिभोज	रत्रिभोज
rabiya	राबिया	रबीय
ramnaam	रामनाम	रमनाम
ramnam	रामनाम	रमनाम
ramsay	रामसे	रामसा
ramse	रामसे	रामसे
ramsey	रामसे	रामसे
ramayan	रामायण	रमायन
ramayana	रामायण	रामायण
rayat	रायट	रायत
writer	रायटर	विटर
writter	रायटर	विटर
raifal	रायफल	रैफल
rifle	रायफल	रिफल
rifles	रायफल्स	रिफल्स
rairangpur	रायरंगपुर	रैरंगपुर
rayrangpur	रायरंगपुर	रायरंगपुर
raashan	राशन	राशन
ration	राशन	रेशन
rashning	राशनिंग	राश्निं
rationing	राशनिंग	रेशनिंग
rashtrasant	राष्ट्रसंत	राष्ट्रसंत
tashtrasant	राष्ट्रसंत	तश्त्रसंत
rashtriyakrit	राष्ट्रीयकृत	राष्ट्रीयकृत
rashtriyekrat	राष्ट्रीयकृत	राष्ट्रीयकृत
rashtriykrut	राष्ट्रीयकृत	राष्ट्रीयकृत
reaction	रिएक्शन	रीक्शन
recover	रिकवर	रिकवर
recognition	रिकॉग्निशन	रिकॉग्निशन
recognization	रिकॉग्निशन	रिकोग्निजे
recall	रिकॉल	रेकल
rico	रिको	रिको
riko	रिको	रिको
rechards	रिचर्ड्स	रेचार्ड्
richards	रिचर्ड्स	रिचार्ड्
richhpal	रिछपाल	रिच्पल
retier	रिटायर	रेटियर
retire	रिटायर	रेटियर
redael	रिडेल	रेडाइ
redel	रिडेल	रेडल
rin	रिन	रीन
reminder	रिमाइंडर	रिमिंडर
riyan	रियान	रियान
riyon	रियान	रियों
relationship	रिलेशनशिप	रिलेशंशिप
revenge	रिवेंज	रिवेंग
rishton	रिश्तों	रिश्तों
rishabh	रिषभ	रिशभ
risala	रिसाला	रिसला
rehayashi	रिहायशी	रहायशी
rihayashi	रिहायशी	रिहायशी
rihayshi	रिहायशी	रिहायशी
reeta	रीटा	रीता
rita	रीटा	रीता
read	रीड	रीड
reed	रीड	रीड
reading	रीडिंग	रीडिंग
redesign	रीडिजाइन	रेडिज्न
recycling	रीसाइकलिंग	रेसिक्लिंग
restart	रीस्टार्ट	रेस्टर्ट
ruki	रुकी	रूकी
ruko	रुको	रुको
rukavat	रूकावट	रुकावट
rukawat	रूकावट	रुकावत
roochi	रूची	रूची
ruchi	रूची	रूची
roote	रूटे	रूटे
rootey	रूटे	रूटे
rute	रूटे	रूटे
roodhir	रूधिर	रूढ़र
rudhir	रूधिर	रूढ़ि
roopaeye	रूपए	रुपा
rupae	रूपए	रूपए
rupaye	रूपए	रुपय
roopkon	रूपकों	रूपकों
rupakon	रूपकों	रूपकों
rengkar	रेंगकर	रेंक्र
rengagti	रेंगती	रेंगेट
rengati	रेंगती	रेंगती
rengti	रेंगती	रेंगटी
registanon	रेगिस्तानों	रेजिस्टनों
razer	रेजर	रेजर
razor	रेजर	राजो
rezer	रेजर	रेजर
raging	रेजिंग	रगिंग
razing	रेजिंग	राजिंग
rejing	रेजिंग	रेजिंग
rates	रेट्स	रेट्स
rest	रेट्स	रेस्ट
raindeer	रेनडियर	रैंडीर
reindeer	रेनडियर	रिंदीर
rendear	रेनडियर	रेनेडर
revoluation	रेवोल्यूशन	रेवोलेशन
revolution	रेवोल्यूशन	रेवोल्यूशन
raindi	रैंडी	रेंदी
randi	रैंडी	रंदी
rendi	रैंडी	रेंदी
rackel	रैकल	रैकल
raikal	रैकल	रैकल
rakel	रैकल	रकेल
rap	रैप	रप
rape	रैप	रपे
rapper	रैपर	रपेर
wrapper	रैपर	वेपर
royal	रॉयल	रोयल
royas	रॉयस	रोयस
royce	रॉयस	रॉयस
roys	रॉयस	रॉयस
ron	रोन	रोन
ronald	रोनाल्ड	रोनल्ड
ronin	रोनिन	रोनिन
rope	रोप	रोप
ropad	रोपड़	रोपड़
ropar	रोपड़	रोपड़
robert	रोबर्ट	रॉबर्ट
roberta	रोबर्टा	रोबरता
romanch	रोमांच	रोमांच
romanchak	रोमांचक	रोमांचक
romanchit	रोमांचित	रोमांछित
romani	रोमानी	रोमानी
romero	रोमेरो	रोमरो
roller	रोलर	रॉलर
roaster	रोस्टर	रोस्टर
roster	रोस्टर	रॉस्टर
langadakar	लंगड़ाकर	लंगड़कर
langarakar	लंगड़ाकर	लंगरकर
langdakar	लंगड़ाकर	लंगदकर
lambai	लंबाई	लंबाई
lanbai	लंबाई	लंबाई
lambe	लंबे	लांब
lakiren	लकीरें	लकीरें
lakshamana	लक्षमण	लक्षमा
lakshman	लक्षमण	लक्ष्म
laxman	लक्षमण	लक्ष्म
lakhatkiya	लखटकिया	लखत्कीय
lakhtakiya	लखटकिया	लखतकीय
lakhanvi	लखनवी	लखन्व
lakhnavi	लखनवी	लखनाव
lakhnawi	लखनवी	लखनाव
lagaakar	लगाकर	लगाकर
lagakar	लगाकर	लगाकर
lachila	लचीली	लचीला
lachili	लचीली	लचीली
latkaya	लटकाया	लटकाया
latkiya	लटकाया	लतकिया
ladkar	लड़कर	लड़कर
ladaakon	लड़ाकों	लड़कों
ladakon	लड़ाकों	लड़कों
lati	लती	लती
latif	लतीफ	लेटि
labh	लभ	ला
laybaddh	लयबद्ध	लयबद्ध
lalkaar	ललकार	लालकर
lalkar	ललकार	लालकर
lalkara	ललकारा	लालकरा
lalkare	ललकारे	लालकरे
lallu	लल्लू	लालू
lahanga	लहंगा	लहंगा
lehenga	लहंगा	लहनगा
la	ला	ला
laa	ला	ला
laanguria	लांगुरिया	लांगुरिया
languria	लांगुरिया	लंगुरिया
languriya	लांगुरिया	लंगुरीय
limestone	लाइमस्टोन	लिमेस्टन
laelaaj	लाइलाज	लायलज
lailaj	लाइलाज	लैलाज
live	लाइव	लिव
life	लाईफ	लाइफ
laoge	लाओगे	लागे
laogey	लाओगे	लागे
laaganey	लागने	लागने
laagne	लागने	लागने
lagne	लागने	लगने
laagu	लागु	लागु
lagu	लागु	लगु
lajimi	लाजिमी	लाजिमी
lajmi	लाजिमी	लाजमी
laate	लाते	लाते
laatey	लाते	लाते
late	लाते	लेट
latehaar	लातेहार	लतेहार
latehar	लातेहार	लतेहर
lateyhaar	लातेहार	लतेहार
laaneyvaley	लानेवाले	लानेवाले
lanevale	लानेवाले	लैनेवाले
lanewale	लानेवाले	लैनेवाले
lions	लायंस	लायंस
lindo	लिंडो	लिंडो
likhane	लिखने	लिखने
likhne	लिखने	लिखने
liga	लिगा	लिगा
linga	लिगा	लिंग
leader	लीडर	लीडर
leaders	लीडर्स	लीडर्स
leipzig	लीप्ज़िग	लिपजिग
lipsing	लीप्ज़िग	लिपिंग
ludhka	लुढ़का	लुढ़का
luthka	लुढ़का	लूठका
lubhavane	लुभावने	लुभावने
lubhawane	लुभावने	लुभावने
lubhawna	लुभावने	लुभावना
lekhon	लेखों	लेखों
letate	लेटते	लेटते
lette	लेटते	लेट
ladies	लेडीज़	लडीज
leti	लेती	लेटी
lenin	लेनिन	लेनिन
label	लेबिल	लेबेल
lebil	लेबिल	लेबिल
lev	लेव	लेव
laigik	लैंगिक	लैगिक
laingik	लैंगिक	लैंगिक
lauch	लॉच	लच
launch	लॉच	लौं
lot	लॉट	लोट
lower	लोअर	लॉवर
loewe	लोई	लोव
loi	लोई	लोई
lokrang	लोकरंग	लोकरंग
logo	लोगो	लोगो
lotpot	लोटपोट	लोटपोट
lop	लोप	लोप
lauki	लौकी	लौकी
loki	लौकी	लोकी
lautai	लौटाई	लौटाई
lautayi	लौटाई	लौटाई
vanchit	वंचित	वांछि
wanchint	वंचित	वांछि
wonders	वंडर्स	वंडर्स
vanshavadi	वंशवादी	वंशावाद
vanshvaadi	वंशवादी	वंश्वाद
vanshvadi	वंशवादी	वंश्वाद
vanshwadi	वंशवादी	वंश्वाद
vadh	वध	वा
vanam	वनम	वनम
vart	वर्ट	वर्त
vert	वर्ट	वेर्
varnawal	वर्णवाल	वर्णवाल
varnvaal	वर्णवाल	वर्णवाल
varnval	वर्णवाल	वर्णवाल
vartika	वर्तिका	वार्तिक
varnaa	वर्ना	वर्णा
verna	वर्ना	वेरना
varshabhar	वर्षभर	वर्षभा
varshbhar	वर्षभर	वर्षभा
varsha	वर्षा	वर्षा
varshaa	वर्षा	वर्षा
warsha	वर्षा	वर्षा
vahneeye	वहनीय	वहनीय
vahniy	वहनीय	वहनीय
wahniy	वहनीय	वहनीय
vaanchoo	वांचू	वांछू
vanchu	वांचू	वांचु
wanchu	वांचू	वांचु
vice	वाइस	विस
vise	वाइस	विसे
wice	वाइस	विस
waters	वाटर्स	वाटर्स
vadakon	वादकों	वादकों
wadkon	वादकों	वाकड़ो
violin	वायलिन	वियोलि
varvik	वारविक	वर्विक
warwick	वारविक	वार्वि
variyar	वारियर	वरियार
warrior	वारियर	वारियर
valekum	वालेकुम	वालेकुम
walaikum	वालेकुम	वालैक्य
walecum	वालेकुम	वालेक्य
walekum	वालेकुम	वालेकुम
vasiyon	वासियों	वासियों
wasion	वासियों	वायून
vastavikta	वास्तविकता	वास्तविकता
vastvikata	वास्तविकता	वास्तविकता
vaahi	वाही	वाही
vahi	वाही	वाही
winters	विंटर्स	विंटर्स
vindhyachal	विंध्याचल	विंध्याचल
vikalp	विकल्प	विकल्प
wicketon	विकेटों	विकेटों
victoria	विक्टोरिया	विक्टोरिया
vicharane	विचारने	विचारणे
vicharne	विचारने	विचारणे
vigyaaniyon	विज्ञानियों	विज्ञानियों
vigyaniyon	विज्ञानियों	विज्ञानियों
wisden	विज्डन	विस्डे
wizdon	विज्डन	विजड़ो
vidaya	विद्या	विदय
vidhya	विद्या	विध्य
vidya	विद्या	विद्य
vidhigya	विधिज्ञ	विधिज्ञ
vidhvans	विध्वंस	विध्वंस
vinivesh	विनिवेश	विनिवेश
vinegar	विनेगर	विनेगर
vinni	विन्नी	विनी
vinny	विन्नी	विन्य
vipreet	विपरीत	विप्री
viprit	विपरीत	विप्रि
vimen	विमेन	विमेन
women	विमेन	वमें
viral	विरल	विरा
viraag	विराग	विराग
virag	विराग	विराग
virodhabhas	विरोधाभास	विरोधासा
virodhiyon	विरोधियों	विरोधियों
vividha	विविधा	विविधा
vividhikaran	विविधीकरण	विविधिकरण
visheshaadhikaaron	विशेषाधिकारों	विशेषाधिकारों
visheshadhikaron	विशेषाधिकारों	विशेषाधिकारों
vishleshan	विश्लेषण	विश्लेषण
vishleshanatmak	विश्लेषणात्मक	विश्लेषणत्मक
vishleshnatmak	विश्लेषणात्मक	विश्लेष्णतामक
vishleshan	विश्लेषणों	विश्लेषण
vishleshanon	विश्लेषणों	विश्लेषणों
vishwabhar	विश्वभर	विश्वभर
vishva	विष्व	विश्व
vishwa	विष्व	विश्व
visangar	विसनगर	विसंगर
visnagar	विसनगर	विस्ना
week	वीक	वीक
veenus	वीनस	वीनस
venus	वीनस	वेनस
vns	वीनस	वीएस
vritt	वृत्त	वृत्त
vrut	वृत्त	वृत
vrutta	वृत्त	वृत्त
vritiyon	वृत्तियों	वृतियों
vrittyon	वृत्तियों	वृत्तियों
vrutiyon	वृत्तियों	वृतियों
vruttiyon	वृत्तियों	वृत्तियों
vegetarian	वेजीटेरियन	वेगेतरियन
wednesday	वेडनसडे	वेडनेडे
weds	वेड्स	वेड्स
ved	वेद	वेद
vedar	वेदर	वेदर
weather	वेदर	वेथर
whether	वेदर	व्हे
vedik	वेदिक	वेदिक
vediyaan	वेदियां	वेदियां
vediyan	वेदियां	वेदियां
variant	वेरिएंट	वारियंट
waste	वेस्ट	वास्त
west	वेस्ट	वेस्ट
wester	वेस्टर	वेस्टर
westor	वेस्टर	वेस्टर
vaigyaanikon	वैज्ञानिकों	वैज्ञानिकों
vaigyanikon	वैज्ञानिकों	वैज्ञानिकों
vaidyaraaj	वैद्यराज	वैद्यारा
vaidyaraj	वैद्यराज	वैद्यारा
vaimansyata	वैमनस्यता	वैमांस्यत
vair	वैर	वैर
vaishno	वैष्णो	वैशनो
water	वॉटर	वाटर
voice	वॉयस	वोइस
warrior	वॉरियर	वारियर
warrioar	वॉरीअर	वारियर
warrior	वॉरीअर	वारियर
walton	वॉल्टन	वाल्टन
valter	वॉल्टर	वाल्टर
vaulter	वॉल्टर	वॉल्टर
wolter	वॉल्टर	वॉटर
vodka	वोडका	वोडका
venkatesh	व्यंकटेश	वेंकटेश
vyankatesh	व्यंकटेश	व्यंकाते
vyanktesh	व्यंकटेश	व्यंकतेश
vyagrata	व्यग्रता	व्यग्रता
vyabhichari	व्यभिचारी	व्यभिचारी
vyavadhanon	व्यवधानों	व्यवधानों
vyavdhanon	व्यवधानों	व्यवधानों
vyavasthapak	व्यवस्थापक	व्यवस्थापक
vyavshthapak	व्यवस्थापक	व्यवश्थापक
vyakhakar	व्याख्याकार	व्याखकार
vyakhyakar	व्याख्याकार	व्याख्यकार
vyapakata	व्यापकता	व्यपकता
vyapakataa	व्यापकता	व्यपकता
vyapakta	व्यापकता	व्यपक्त
viewer	व्यूअर	व्यूर
vratraj	व्रतराज	वृत्राज
wear	व्हेयर	वेयर
where	व्हेयर	व्हेरे
shakuntala	शकुंतला	शकुंतला
shakuntla	शकुंतला	शकुंतला
shankutla	शकुंतला	शंकुटला
shakki	शक्की	शक्की
shakt	शक्त	शक्त
shatpratishat	शतप्रतिशत	शत्प्रतिष
shatakshi	शताक्षी	शतक्षी
shafi	शफी	शफी
shabe	शबे	शबे
shamoon	शमून	शमून
shamun	शमून	शमुन
shmoon	शमून	शमून
shmun	शमून	शमुन
sharfuddin	शरफुद्दीन	शरफुद्दीन
sharman	शरमन	शर्म
sharaab	शराब	शराब
sharab	शराब	शराब
shrab	शराब	श्रब
sharaabiyon	शराबियों	शराबियों
sharabiyon	शराबियों	शराबियों
shrabiyon	शराबियों	श्रबियों
sharaabi	शराबी	शराबी
shrabi	शराबी	श्रबी
shararti	शरारती	शरारती
shrarti	शरारती	श्ररती
shararaton	शरारतों	शरारतों
shararton	शरारतों	शरारतों
shrarton	शरारतों	श्रृतों
shareer	शरीर	शरीर
sharir	शरीर	शरीर
sharirdhari	शरीरधारी	शरीर्धार
sharirvigyan	शरीरविज्ञान	शरीर्विज्ञा
shariri	शरीरी	शरीरी
shariiron	शरीरों	शरीरों
shariron	शरीरों	शरीरों
shahnawaaz	शहनवाज	शहनवाज
shahnawaz	शहनवाज	शहनवाज
shehnawaz	शहनवाज	शहनावज
shahar	शहर	शाह
shehar	शहर	शहर
shehr	शहर	शहर
shahariyon	शहरियों	शहरीयों
shahriyon	शहरियों	शहरियों
shaharikaran	शहरीकरण	शहरीकरण
shahrikaran	शहरीकरण	शहरीकरण
shehrikarn	शहरीकरण	शहरीकरण
shaaririk	शारिरिक	शारीरिक
sharirik	शारिरिक	शरीरिक
shalimar	शालीमार	शलीमार
shaavaka	शावक	शावक
shavak	शावक	शावक
shaasakiya	शासकीय	शासकीय
shasakiy	शासकीय	शासकीय
shasakiya	शासकीय	शासकीय
shaskiy	शासकीय	शास्कि
shahjahani	शाहजहानी	शहजाहनी
shikan	शिकन	शिकन
shinaakhta	शिनाख्त	शिनाख्त
shinakhat	शिनाख्त	शिनखात
shinakht	शिनाख्त	शिनख्त
shivcharan	शिवचरण	शिवचार
shivatv	शिवत्व	शिवत्व
shivtv	शिवत्व	शिवत्व
sheohar	शिवहर	शेहार
shivhar	शिवहर	शिव्ह
sheera	शीरा	शीरा
shira	शीरा	शीरा
sheershak	शीर्षक	शीर्षक
shirshak	शीर्षक	शिर्षक
shubhaarambh	शुभारंभ	शुभारंभ
shubharambh	शुभारंभ	शुभारंभ
shubhaashubh	शुभाशुभ	शुभाषुभ
shubhashubh	शुभाशुभ	शुभाषुभ
shubhra	शुभ्रा	शुभरा
shubra	शुभ्रा	शुब्र
shuraat	शुरुवात	शुरात
shuruvaat	शुरुवात	शुरूवात
shuruvat	शुरुवात	शुरूवत
shuruaati	शुरूआती	शुरुआती
shooker	शूकर	शूकर
shukar	शूकर	शुकर
shane	शेन	शान
shen	शेन	शेन
shephard	शेफर्ड	शेफार्
shepherd	शेफर्ड	शेफ़र्
sheru	शेरू	शेरू
sheruu	शेरू	शेरू
shoulder	शोल्डर	शौल्डर
shmashaan	श्मशान	शमाशान
shmashan	श्मशान	शमाशन
shyaamdaas	श्यामदास	श्यामदास
shyamdas	श्यामदास	श्यामदास
shraddheya	श्रद्धेय	श्रद्धेय
shradhey	श्रद्धेय	श्राध्य
shravan	श्रावण	श्रवण
shrawan	श्रावण	श्रवाण
shrota	श्रोता	श्रोता
shasht	षष्ठ	शश्त
shashth	षष्ठ	शश्थ
sankalpana	संकल्पना	संकलपना
sanke	संके	संके
sankraanti	संक्रांति	संक्रांति
sankranti	संक्रांति	संक्रांति
sankhy	संख्य	संख्य
sankhya	संख्य	संख्य
sanghatan	संघठन	संघात
sanghathan	संघठन	संघठन
sanghthan	संघठन	संघठन
sangham	संघम	संघम
sngham	संघम	स्नह
sanchay	संचय	संचा
sanchaya	संचय	संचा
sanchaarit	संचारित	संचारित
sancharit	संचारित	संचारित
sanchaalan	संचालन	संचालन
sanchalan	संचालन	संचलन
sanjeeda	संजीदा	संजीदा
sanjida	संजीदा	संजीदा
sanju	संजू	संजु
sandarbhit	संदर्भित	संदर्भित
sandrbhit	संदर्भित	संद्रभित
sandeep	संदीप	संदीप
sandip	संदीप	संदिप
sandipa	संदीपा	संदिपा
sandehjanak	संदेहजनक	संदेहजनक
samposhit	संपोषित	संपोषित
samprag	संप्रग	संप्रग
sanprg	संप्रग	सैंप्र
sambhalani	संभालनी	संभालनी
sambhalni	संभालनी	संभालनी
samyuktataa	संयुक्तता	सम्युक्तत
sanyuktata	संयुक्तता	संयुक्तता
sanyojak	संयोजक	संयोजक
sanyojakata	संयोजकता	संयोजकता
sanyojkta	संयोजकता	संयोजकता
samvedanheen	संवेदनहीन	संवेदनहीन
sanvedanheen	संवेदनहीन	संवेदनहीन
sanvedanhin	संवेदनहीन	संवेदनहीन
sanshay	संशय	संशय
sanskaarit	संस्कारित	संस्कारित
sanskarit	संस्कारित	संस्कारित
sanskarita	संस्कारित	संस्कारित
sanskaaron	संस्कारो	संस्कारो
sanskaro	संस्कारो	संस्कारो
sanskaron	संस्कारो	संस्कारो
sanskaaron	संस्कारों	संस्कारों
sanskaron	संस्कारों	संस्कारों
sankritnishth	संस्कृतनिष्ठ	संकृतिष्ठ
sanskritnisht	संस्कृतनिष्ठ	संस्कृत्तित
sanskrutnishth	संस्कृतनिष्ठ	संस्कृत्रिष्
sanskriti	संस्तुति	संस्कृति
sanstuti	संस्तुति	संस्तुति
sakal	सकल	सकल
sakling	सकलिंग	सैकलिं
suckling	सकलिंग	सुकलिं
sakengi	सकेंगी	सकेंगी
sachhidanandan	सच्चिदानंदन	सच्चीदानंदन
sachidanand	सच्चिदानंदन	सचिद्दानंद
satchidanandan	सच्चिदानंदन	सतचिद्नांदन
sajdhaj	सजधज	सजधा
sajjit	सज्जित	सज्जित
satnaam	सतनाम	सतनाम
satnam	सतनाम	सतनाम
sattar	सत्तर	सत्तर
satyaveer	सत्यवीर	सत्यवीर
satyavir	सत्यवीर	सत्यविर
satya	सत्या	सत्य
satyaansh	सत्यांश	सत्यांश
satyansh	सत्यांश	सत्यांश
sadarang	सदारंग	सदरंग
sadashivarao	सदाशिवराव	सदशीवराव
sadashivram	सदाशिवराव	सदशिवर्म
sadashivrao	सदाशिवराव	सदशीवराव
sunrise	सनराइज	सुनरीज
sanaya	सनाया	सनय
sani	सनी	सान
sunny	सनी	सुन
sapt	सप्त	सप्त
sapta	सप्त	सप्त
saptarishi	सप्तर्षि	सप्तऋषि
saptarshi	सप्तर्षि	सप्तर्शि
safi	सफी	सफी
sabhasad	सभासद	सभासद
sabhyataon	सभ्यताओं	सभ्यताओं
samajhaute	समझौते	समझौते
samjhaute	समझौते	समझौते
samarthit	समर्थित	समर्थित
samrthit	समर्थित	सम्रथित
samaadhanon	समाधानों	समाधनों
samadhanon	समाधानों	समाधनों
samaadhi	समाधि	समाधी
samadhi	समाधि	समाधी
samudratat	समुद्रतट	समुद्रतत
sayajirao	सयाजीराव	सायजीरा
ssayajirao	सयाजीराव	ससायजरा
sanrachna	सरंचना	संरचना
saranchana	सरंचना	सरंचना
sarakte	सरकते	सरकते
sarkte	सरकते	सरकते
sarkaar	सरकार	सरकार
sarkar	सरकार	सरकर
sarnobat	सरनोबत	सरणोबत
saras	सरस	सरस
sarasta	सरसता	सरसता
sarsata	सरसता	सरसता
sarsta	सरसता	सरस्त
saraah	सराह	सराह
sarah	सराह	सरह
sareaam	सरेआम	सरेम
circular	सर्कुलर	सर्कलार
sarvashaktimaan	सर्वशक्तिमान	सर्वशक्तिमान
sarvashaktiman	सर्वशक्तिमान	सर्वशक्तिमान
sarvshaktiman	सर्वशक्तिमान	सर्वशक्तिमान
sarvoday	सर्वोदय	सर्वोदय
sarvodaya	सर्वोदय	सर्वोदय
sarwoday	सर्वोदय	सरवोदय
salwar	सलवार	सलवर
salae	सलाई	सलाए
salai	सलाई	सलाई
slaai	सलाई	स्ला
salaahkaron	सलाहकारों	सलाहकारों
salahkaron	सलाहकारों	सलाहकारों
salaahiyat	सलाहियत	सलाहियत
salahiyat	सलाहियत	सलाहियत
savaliya	सवालिया	सवालिया
sawaliya	सवालिया	सवालिया
savalon	सवालों	सवालों
sawalon	सवालों	सवालों
sashankit	सशंकित	सशनकित
sahasansthapak	सहसंस्थापक	सहसंस्थापक
sahsanstapak	सहसंस्थापक	सहसंस्तापक
sahsansthapak	सहसंस्थापक	सहसंस्थापक
sahi	सही	साह
sampradayik	सांप्रदायिक	संप्रादायिक
sampradayika	सांप्रदायिक	संप्रदायिका
sampradayikata	सांप्रदायिकता	संप्रदायिकता
sampradayikta	सांप्रदायिकता	संप्रदायिकता
saaj	साज	साज
saj	साज	सज
saajon	साजों	साजों
sajon	साजों	सजों
sajhedaar	साझेदार	साझेदार
sajhedar	साझेदार	साझेदार
sana	साना	साना
sarvabhaunik	सार्वभौमिक	सर्वाभानिक
sarvbhaumik	सार्वभौमिक	सर्वभामिक
saarvabhaumikataa	सार्वभौमिकता	सार्वभौमिकता
sarvabhaumikata	सार्वभौमिकता	सर्वभामिकता
sarvabhaumikta	सार्वभौमिकता	सर्वाभामिकता
sarvbhaumikata	सार्वभौमिकता	सर्वभौमिकता
saleh	सालेह	सलेह
sahabon	साहबों	सहबों
sahbon	साहबों	सहबों
saha	साहा	सहा
sahit	साहित	सहित
sahebganj	साहिबगंज	सहेबगंज
sahibganj	साहिबगंज	सहीबगंज
singhe	सिंघे	सिंहे
singhey	सिंघे	सिंहे
syndicate	सिंडिकेट	सिंडिकेट
cindi	सिंडी	सिंडी
sindi	सिंडी	सिंदी
sindy	सिंडी	सिंडी
sindhughosh	सिंधुघोष	सिंधुघोष
sindhugosh	सिंधुघोष	सिंधुगोष
singh	सिंह	सिंह
sinh	सिंह	सिंह
sinha	सिंह	सिन्
sikudta	सिकुड़ता	सिकुड़ता
sikudan	सिकुड़न	सिकुड़न
sikuda	सिकुड़ा	सिकुड़ा
sikudi	सिकुड़ी	सिकुड़ी
sikude	सिकुड़े	सिकुड़े
sikudey	सिकुड़े	सिकुड़े
sikhana	सिखाना	सिखाना
signal	सिगनल	सिग्न
signallon	सिगनलों	सिग्नलो
signalon	सिगनलों	सिग्नलो
cipla	सिपला	सिप्ल
simaria	सिमरिया	सिमरीय
simariya	सिमरिया	सिमरीय
simriya	सिमरिया	सिमरिया
siyar	सियर	सियर
sirf	सिर्फ	सीरफ
sivrej	सिवरेज	सिवरेज
sivana	सिवाना	सिवाना
siwana	सिवाना	सिवना
sihava	सिहावा	सिहावा
cis	सीआईएस	सीएस
cec	सीईसी	सीसी
cafa	सीएफए	कैफा
cfa	सीएफए	सीएफ
cl	सीएल	सीएल
csir	सीएसआईआर	सीएसआई
cedan	सीडान	सेडन
sidan	सीडान	सिदान
sitapur	सीतापुर	सितापुर
sitarmaiya	सीतारमैया	सितरमैय
sitarmaiyya	सीतारमैया	सितरमयय
sitarmayya	सीतारमैया	सितरमयय
seedha	सीधा	सीढ़
sidha	सीधा	सिध्
sceney	सीने	सीनी
sine	सीने	सीने
cvc	सीवीसी	सीवीसी
sehore	सीहोर	सेहोर
sihor	सीहोर	सिहोर
sung	सुंग	सुंग
suites	सुइट्स	सुइट्स
suits	सुइट्स	सुइट्स
sukama	सुकमा	सुकाम
sukma	सुकमा	सुक्म
sukhate	सुखाते	सुखाते
sugam	सुगम	सुगम
sujay	सुजय	सुजा
sujaan	सुजान	सुजान
sujan	सुजान	सुजन
sudipta	सुदिप्ता	सुदिप्ता
sudharane	सुधरने	सुधरने
sudharney	सुधरने	सुधरने
sudhrane	सुधरने	सुधरान
sudharma	सुधर्मा	सुधर्म
sudheesh	सुधीश	सुधीश
sudhish	सुधीश	सुधिश
suneet	सुनीत	सुनीत
sunit	सुनीत	सुनित
supernova	सुपरनोवा	सुपरणोवा
sufal	सुफल	सुफल
subah	सुबह	सुबा
subeh	सुबह	सुबे
subbarao	सुब्बाराव	सबबराओ
subbarav	सुब्बाराव	सुबराव
sumantr	सुमंत्र	सुमंत्र
sumantra	सुमंत्र	सुमंत्र
sumerpur	सुमेरपुर	सुमेरपुर
surakshit	सुरक्षित	सुरक्षित
surkshit	सुरक्षित	सुरक्षित
sooraj	सुरज	सूरा
suraj	सुरज	सुरज
surjan	सुरजन	सुरजन
suraji	सुराजी	सुराजी
suljhaaya	सुलझाया	सुलझाया
suljhaayaa	सुलझाया	सुलझाया
suljhaya	सुलझाया	सुलझाया
suljhayaa	सुलझाया	सुलझाया
sulzaya	सुलझाया	सुलझाया
sultan	सुलतान	सुल्ता
sultana	सुलतान	सुलतान
sultaanon	सुलतानों	सुलतानों
sultanon	सुलतानों	सुल्तानो
sulzanon	सुलतानों	सुलझानों
subarna	सुवर्ण	सुबरना
suvarn	सुवर्ण	सुवर्ण
suvran	सुवर्ण	सुवरण
susajjit	सुसज्जित	सुसज्जित
susan	सुसन	सुसन
suchakon	सूचकों	सुचाको
suchkon	सूचकों	सुचकों
suchnaen	सूचनाऐं	सुचनाएं
suchnayen	सूचनाऐं	सुचनाएं
sooje	सूजे	सूजे
suje	सूजे	सुजे
sudan	सूडान	सुदान
sootak	सूतक	सूतक
sutak	सूतक	सुटक
sutrapat	सूत्रपात	सुत्रापत
sense	सेंस	सेंस
set	सेट	सेट
setting	सेटिंग	सेटिंग
seton	सेटों	सेतों
setton	सेटों	सेतों
sets	सेट्स	सीट्स
senapatitv	सेनापतित्व	सेनापतिव
senapatitva	सेनापतित्व	सेनापतित्व
sebastian	सेबास्टियन	सेबस्तियां
sebastiyan	सेबास्टियन	सेबस्तियां
seminari	सेमिनरी	सेमीनार
seminary	सेमिनरी	सेमिनार
semi	सेमी	सेमी
seri	सेरी	सेरी
selangor	सेलांगोर	सेलंगोर
celina	सेलीना	सेलिना
selina	सेलीना	सेलिना
sevak	सेवक	सेवक
sewak	सेवक	सेवक
saving	सेविंग	सैविंग
sevit	सेवित	सेवित
seviyon	सेवियों	सेवियों
sesana	सेसना	सेसना
sesanaa	सेसना	सेसना
sesna	सेसना	सेसना
saikado	सैकडो	सैकड़
saikdo	सैकडो	सैकड़
saturn	सैटर्न	सतूर्ण
suturn	सैटर्न	सूतर्न
sainik	सैनिक	सैनिक
sainikon	सैनिकों	सैनिकों
socket	सॉकेट	सोकेट
song	सॉन्ग	सोंग
sochati	सोचती	सोचती
sochti	सोचती	सोचती
songara	सोनगरा	सोंगरा
sono	सोनो	सोनो
som	सोम	सोम
soman	सोमन	सोमन
soman	सोमान	सोमन
somalia	सोमालियाई	सोमलिया
somaliyai	सोमालियाई	सोमलियाई
somaiya	सोमैया	सोमैया
solahaven	सोलहवें	सोलहवें
solhaven	सोलहवें	सोलहवें
social	सोशल	सोसि
soshal	सोशल	सोशल
saudon	सौदों	सौदों
sodon	सौदों	सोड़ो
sauhard	सौहार्द	सौहार्ड
sauharda	सौहार्द	सौहार्द
souharda	सौहार्द	सौहार्द
scotish	स्काॅटिश	स्कॉटिश
scottish	स्काॅटिश	स्कॉटिश
skip	स्किप	स्किप
scoop	स्कूप	स्कूप
skoop	स्कूप	स्कूप
scan	स्कैन	स्केन
scanner	स्कैनर	स्कैनर
skhalit	स्खलित	स्खलित
startup	स्टार्टअप	स्तरूप
steamer	स्टीमर	स्टीमर
stimer	स्टीमर	स्टिमर
stanley	स्टेनले	स्टेनली
stallone	स्टेलोन	स्टॉलोन
standby	स्टैंडबाय	स्टेंडबी
static	स्टैटिक	स्टेटिक
stallone	स्टैलोन	स्टॉलोन
streep	स्ट्रीप	स्ट्रीप
strip	स्ट्रीप	स्ट्रिप
stripe	स्ट्रीप	स्ट्रिप
strock	स्ट्रोक	स्ट्रॉक
stroke	स्ट्रोक	स्ट्रोक
stanon	स्तनों	स्तनों
stotra	स्तोत्र	स्तोत्र
stritv	स्त्रीत्व	स्ट्रिट्व
stritva	स्त्रीत्व	स्तृत्व
stotra	स्त्रोत्र	स्तोत्रा
strot	स्त्रोत्र	स्ट्रोट
strotra	स्त्रोत्र	स्त्रोत्र
sthit	स्थित	स्थित
sthithi	स्थिति	स्थिथी
sthiti	स्थिति	स्थिती
sthiti	स्थिती	स्थिती
sniper	स्नाइपर	स्नीपर
snnaiper	स्नाइपर	स्नैपेप
spaek	स्पाइक	स्पेक
spike	स्पाइक	स्पिक
spiderman	स्पाइडरमैन	स्पाइडरमैन
spelling	स्पेलिंग	स्पेलिंग
spoted	स्पॉटेड	स्पॉटड
spotted	स्पॉटेड	स्पॉटड
spilit	स्प्लिट	स्पिलिट
split	स्प्लिट	स्प्लिट
smooth	स्मूथ	स्मूथ
slab	स्लैब	स्लेब
slam	स्लैम	स्लैम
svatantr	स्वतंत्र	स्वतंत्र
swatantr	स्वतंत्र	स्वतंत्र
swatantra	स्वतंत्र	स्वतंत्र
svabhav	स्वभाव	स्वाभा
swabhaav	स्वभाव	स्वभाव
swabhav	स्वभाव	स्वाभा
svabhabon	स्वभावों	स्वभाबों
swabhaavon	स्वभावों	स्वभावों
swabhavon	स्वभावों	स्वाभावो
swayamvar	स्वयंवर	स्वायवर
swayanvar	स्वयंवर	स्वयंवर
swarup	स्वरुप	स्वरूप
swarkal	स्वर्णकाल	स्वर्कल
swarnakaal	स्वर्णकाल	स्वर्णकाल
swarnakal	स्वर्णकाल	स्वर्णाका
swan	स्वां	स्वान
swang	स्वांग	स्वंग
swati	स्वाती	स्वती
swaamiyon	स्वामियों	स्वामियों
swamion	स्वामियों	स्वामियों
swamiyon	स्वामियों	स्वामियों
switched	स्विच्ड	स्विच्छ
swedish	स्विडिश	स्वेदिश
swidish	स्विडिश	स्विदिश
sweety	स्वीटी	स्वीटी
sweets	स्वीट्स	स्वीट्स
sweeper	स्वीपर	स्वीपर
sweat	स्वेट	स्वेट
swet	स्वेट	स्वेट
hansadaa	हंसदा	हंसदा
hansda	हंसदा	हंसदा
haklaate	हकलाते	हकलाते
haklate	हकलाते	हकलते
hakka	हक्का	हक्का
sakka	हक्का	सकका
hatana	हटना	हटना
hatna	हटना	हटना
hatane	हटने	हटान
hatne	हटने	हटने
hate	हते	हात
hatha	हत्था	हथाा
hattha	हत्था	हट्ठा
hatya	हत्था	हट्य
hatyaein	हत्याएं	हट्याएं
hatyaen	हत्याएं	हट्याएं
hatyayen	हत्याएं	हट्याएं
hanut	हनुत	हनुत
habshi	हब्शी	हांशी
hubshi	हब्शी	हुश्च
humdam	हमदम	हमदा
humdum	हमदम	हमदु
hamaad	हमाद	हमाद
hamad	हमाद	हमाद
humad	हमाद	हमाद
hamirpur	हमीरपुर	हमीरपुर
hayagreev	हयग्रीव	हायाग्र
hayagreeva	हयग्रीव	हयाग्री
hayagriva	हयग्रीव	हायग्री
haygreev	हयग्रीव	हायग्री
hardam	हरदम	हरदम
hurdum	हरदम	हुर्
harad	हरदा	हरद
harda	हरदा	हरदा
harbart	हरबर्ट	हरबरत
harburt	हरबर्ट	हरबरत
herbert	हरबर्ट	हरबर्ट
haryaanavi	हरयाणवी	हरयानवी
haryanvi	हरयाणवी	हरयंवी
harsiddhi	हरसिध्दि	हरसिद्धि
harsh	हर्ष	हर्ष
harsha	हर्षा	हर्षा
harshik	हर्षिका	हर्षिक
harshika	हर्षिका	हर्षिका
haldighaati	हल्दीघाटी	हलदीघाती
haldighati	हल्दीघाटी	हलदीघाती
havas	हवस	हवा
hawas	हवस	हवा
havaen	हवाएं	हवाएं
hawayein	हवाएं	हवाएं
hawayen	हवाएं	हवाएं
havao	हवाओ	हवाओ
hawaao	हवाओ	हवाओ
hawao	हवाओ	हवाओ
havas	हवास	हवास
hawaas	हवास	हवास
hawas	हवास	हवास
haseen	हसीन	हसीन
hasin	हसीन	हासी
hypo	हाइपो	हाइपो
hypothalamus	हाइपोथैलेमस	हिपोथलमस
hijack	हाईजैक	हिजक
haitec	हाईटेक	हैटेक
hightake	हाईटेक	हाइटके
hightech	हाईटेक	हाइटेक
hitake	हाईटेक	हिटके
hiteck	हाईटेक	हिटकेक
hypertension	हाईपरटेंशन	हिपर्टनेशन
houses	हाउसेस	हॉसेज
hathve	हाथवे	हथवे
hathway	हाथवे	हथवे
hyman	हायमन	हाम्न
hymen	हायमन	हामेन
halia	हालिया	हलिया
haliya	हालिया	हलिया
haashmi	हाश्मी	हाशमी
hashmi	हाश्मी	हश्मी
hidavi	हिंदवी	हिडवी
hindavi	हिंदवी	हिंदवी
hindvi	हिंदवी	हिंदवी
hichkichate	हिचकिचाते	हिचकिचते
hichkichane	हिचकिचाने	हिचकिचने
hitkar	हितकर	हितकर
hindi	हिन्दी	हिंदी
hiran	हिरण	हिरन
hilakar	हिलाकर	हिलाकर
hilaal	हिलाल	हिलाल
hilal	हिलाल	हिलाल
hinsa	हिसा	हिंस
hisa	हिसा	हिसा
hiss	हिस्स	हिस
hissa	हिस्स	हिस्स
hirachand	हीराचंद	हिरचंद
hue	हुऐ	ह्य
hujum	हुजूम	हुजुम
hood	हुड	हुड
hud	हुड	हुड
hunar	हुनर	हुनर
hoon	हूँ	हून
hun	हूँ	हुन
hetu	हेतु	हेतु
herald	हेराल्ड	हेरल्ड
helmet	हेल्मेट	हेलमेट
haven	हेवन	हवें
heaven	हेवन	हीवन
haidarabad	हैदराबाद	हैदरबाद
hyderabad	हैदराबाद	हाइडराबा
hyderabadi	हैदराबादी	हाइडराबाड
halloween	हैलोवीन	हलोवीन
helloveen	हैलोवीन	हेलोवीन
haiwaan	हैवान	हैवान
havan	हैवान	हवान
heyvan	हैवान	हेवान
hash	हैश	हाश
hop	हॉप	हॉप
hope	हॉप	होप
hopes	हॉप्स	हॉप्स
hops	हॉप्स	हॉप्स
halt	हॉल्ट	हैल्ट
hault	हॉल्ट	हॉल्ट
hostelon	हॉस्टलों	हॉस्टलों
hon	हों	हों
hojri	होजरी	होजरी
hojry	होजरी	होजरी
hosiery	होजरी	हॉसिय
hota	होता	होता
homepage	होमपेज	होमपेज
hold	होल्ड	हॉल्ड
holder	होल्डर	लॉड्र
hosho	होशो	होशो
huar	ह्यूअर	हुआर
hyuar	ह्यूअर	युआर
hyuer	ह्यूअर	यूयर
